15 20
###############
#   #       # #
#   # # #    ##
#1 ##      # ##
#    ##       #
#  #          #
# #         # #
## # ##       #
### #     #   #
#       #     #
#     #       #
#   #     # ###
#       ## # ##
# #         # #
#          #  #
#       ##    #
## #      ## 2#
##    # # #   #
# #       #   #
###############
