30 17
##############################
#   # #     #   ##     # ## ##
###        #   ### # #       #
# ##  #    ##    #      #    #
#     #     # #   #          #
###  #  #             #  #  ##
#  # 1  ##    ## #  #       ##
#              #  #          #
# ## #  #     ##     #  # ## #
#          #  #              #
##       #  # ##    ##  2 #  #
##  #  #             #  #  ###
#          #   # #     #     #
#    #      #    ##    #  ## #
#       # # ###   #        ###
## ## #     ##   #     # #   #
##############################
