29 22
#############################
#  #             #          #
# #                       # #
#                  #  #    ##
#         2   ###    #  #   #
#                          ##
#      #         #          #
#               #          ##
#          #             #  #
#        #     #       #    #
# #   #          #          #
#          #          #   # #
#    #       #     #        #
#  #             #          #
##          #               #
#          #         #      #
##                          #
#   #  #    ###   1         #
##    #  #                  #
# #                       # #
#          #             #  #
#############################
