39 46
#######################################
#  #    #  ###                 #   #  #
##               # #       #      #   #
#                                     #
#   #                         ### # # #
# #      #     ##       #       #    ##
#  #        #      #           #   ####
##                      #   ##        #
#             #                       #
#              #         #  # #       #
#      #  #                           #
#            ##             #    #    #
#                       #   ##        #
#                      #         #  # #
#   #        #           #        #   #
# #  #        #                     # #
#    #      #    #                    #
#  ##    #   #   # #  #          2    #
##                  #     # #      #  #
#                       #     #  #    #
##                  #                 #
#           #        # #        # #  ##
# #  #    #   #          #     #      #
#      #     #          #   #    #  # #
##  # #        # #        #           #
#                 #                  ##
#    #  #     #                       #
#  #      # #     #                  ##
#    1          #  # #   #   #    ##  #
#                    #    #      #    #
# #                     #        #  # #
#   #        #           #        #   #
# #  #         #                      #
#        ##   #                       #
#    #    #             ##            #
#                           #  #      #
#       # #  #         #              #
#                       #             #
#        ##   #                      ##
####   #           #      #        #  #
##    #       #       ##     #      # #
# # # ###                         #   #
#                                     #
#   #      #       # #               ##
#  #   #                 ###  #    #  #
#######################################
