19 22
###################
# #  #    #     # #
#    # #          #
#        #        #
#      #          #
#        #    #   #
#                 #
#1   #      #    ##
# #   #     #    ##
#    #            #
#                 #
#                 #
#            #    #
##    #     #   # #
##    #      #   2#
#                 #
#   #    #        #
#          #      #
#        #        #
#          # #    #
# #     #    #  # #
###################
