26 15
##########################
#   #          #        ##
#              # #       #
# #  #   #             2 #
#  ##  ##         #     ##
#    #          #   #    #
#    #            ## #   #
##                      ##
#   # ##            #    #
#    #   #          #    #
##     #         ##  ##  #
# 1             #   #  # #
#       # #              #
##        #          #   #
##########################
