15 30
###############
#     #     # #
#  #       ## #
#2     #   #  #
#            ##
#             #
#            ##
#   ##        #
#             #
#             #
#     #       #
#         #   #
#           # #
#             #
#             #
#             #
#             #
# #           #
#   #         #
#       #     #
#             #
#             #
#        ##   #
##            #
#             #
##            #
#  #   #     1#
# ##       #  #
# #     #     #
###############
