30 15
##############################
# #    #            # # ##   #
#           #      ##    #   #
#     #1                     #
# #                       #  #
##      # #         # #      #
#             #             ##
##         ##    ##         ##
##             #             #
#      # #         # #      ##
#  #                       # #
#                     2#     #
#   #    ##      #           #
#   ## # #            #    # #
##############################
