30 29
##############################
#                            #
#   #              #         #
#      ## ##   #             #
#              #          #  #
#                            #
#         #                  #
#          # #               #
#       #          # 2       #
#   #                        #
#             # #          # #
# #          #            #  #
#        # # #           #   #
##                      #    #
# # # #                # # # #
#    #                      ##
#   #           # # #        #
#  #            #          # #
# #          # #             #
#                        #   #
#       1 #          #       #
#               # #          #
#                  #         #
#                            #
#  #          #              #
#             #   ## ##      #
#         #              #   #
#                            #
##############################
