22 17
######################
#   ##  #            #
#       ##          ##
#        #     #   ###
# #        #  # # ## #
#                  # #
# 2   #  #           #
#                 #  #
#                    #
#  #                 #
#           #  #   1 #
# #                  #
# ## # #  #        # #
###   #     #        #
##          ##       #
#            #  ##   #
######################
