29 28
#############################
#         #                 #
# #  #  # #            #    #
# #       ##      # #     # #
#  ##  ##        # # #      #
#    #         #     #      #
##              #    # #  # #
####           #        #   #
#       #  # # #            #
#      #    ###     #       #
# # #   ##   ##   2         #
#     #  #         ### #  ###
## #       #     #        # #
#       ###    #    #       #
#       #    #    ###       #
# #        #     #       # ##
###  # ###         #  #     #
#         1   ##   ##   # # #
#       #     ###    #      #
#            # # #  #       #
#   #        #           ####
# #  # #    #              ##
#      #     #         #    #
#      # # #        ##  ##  #
# #     # #      ##       # #
#    #            # #  #  # #
#                 #         #
#############################
