18 17
##################
# #       #    # #
##        ### #  #
#   #    ##   #  #
#      1  #  #   #
#    #       #   #
# #      ##  #   #
## ###  #        #
# # #        # # #
#        #  ### ##
#   #  ##      # #
#   #       #    #
#   #  #  2      #
#  #   ##    #   #
#  # ###        ##
# #    #       # #
##################
