21 20
#####################
#           #       #
#   # #   #   # #   #
# # #         1     #
#   #               #
#    #             ##
#                   #
#  #         #      #
# #        #        #
#                   #
#                   #
#        #        # #
#      #         #  #
#                   #
##             #    #
#               #   #
#     2         # # #
#   # #   #   # #   #
#       #           #
#####################
