21 18
#####################
#        #         2#
#  #        ##      #
# # #  #            #
##        # #       #
#         #         #
# ##   #       ##   #
#                   #
#                   #
#                   #
#                   #
#   ##       #   ## #
#         #         #
#       # #        ##
#            #  # # #
#      ##        #  #
#1         #        #
#####################
