18 19
##################
## #   ###   #   #
#  #  #  #   #   #
#  # #      #    #
##   #       # ###
#      # 2 #  #  #
# #  # #         #
#    #           #
#  #            ##
# #            # #
##            #  #
#           #    #
#         # #  # #
#  #  # 1 #      #
### #       #   ##
#    #      # #  #
#   #   #  #  #  #
#   #   ###   # ##
##################
