16 27
################
#       #      #
#       #      #
#     ##      ##
#    #  # 2#   #
# #  ##    #   #
#   ##         #
#  #  #     #  #
#    #         #
###    ## #  # #
#  # # #  #    #
#  ##     #    #
#     # ###    #
# #          # #
#    ### #     #
#    #     ##  #
#    #  # # #  #
# #  # ##    ###
#         #    #
#  #     #  #  #
#         ##   #
#   #    ##  # #
#   #1 #  #    #
##      ##     #
#      #       #
#      #       #
################
