21 16
#####################
#                   #
#  #           #    #
#          #        #
#                   #
# ## 2 ##         ###
#     #     # # #   #
#         # # #     #
#     # # #         #
#   # # #     #     #
###         ## 1 ## #
#                   #
#        #          #
#    #           #  #
#                   #
#####################
