38 39
######################################
##    #     #   #  ##  ## 2  # # #  ##
#   #  ##      #   #   # ##          #
#    ##   #   ##   # #         #     #
# #           #####  #   ## ##   #  ##
#  #    #    #   #      ### #   # #  #
#    #    #     #    #      ## #  #  #
##       # #    #  #     ## #    #   #
#    #        #     #     ##      ## #
##  #    ##   #  #         #         #
# #  ###     ## ### #       #  #  # ##
# #       ####     # #  # #      #   #
#  ##    #          # #  #       #   #
#  #    # #          # #  #    ###   #
# #    #    #   #   # #    ### #    ##
#  ###     ##          # #       #   #
##       #       #            ##     #
# #        #    #       #  #         #
#   #             #   #  ##    #   ###
#    #  ##                  ##  #    #
###   #    ##  #   #             #   #
#         #  #       #    #        # #
#     ##            #       #       ##
#   #       # #          ##     ###  #
##    # ###    # #   #   #    #    # #
#   ###    #  # #          # #    #  #
#   #       #  # #          #    ##  #
#   #      # #  # #     ####       # #
## #  #  #       # ### ##     ###  # #
#         #         #  #   ##    #  ##
# ##      ##     #     #        #    #
#   #    # ##     #  #    # #       ##
#  #  # ##      #    #     #    #    #
#  # #   # ###      #   #    #    #  #
##  #   ## ##   #  #####           # #
#     #         # #   ##   #   ##    #
#          ## #   #   #      ##  #   #
##  # # #  1 ##  ##  #   #     #    ##
######################################
