17 26
#################
#   # #         #
# #             #
##              #
#        #      #
#    1    ##    #
#          #  # #
##  #         # #
#               #
#              ##
#               #
#     # #       #
#              ##
##              #
#       # #     #
#               #
##              #
#               #
# #         #  ##
# #  #          #
#    ##    2    #
#      #        #
#              ##
#             # #
#         # #   #
#################
