26 17
##########################
# ###                    #
#  1         #           #
# #          ##       # ##
#  ##  #     ##       ####
#     #  #  ##           #
# #                      #
##               #     ###
#    #              #    #
###     #               ##
#                      # #
#           ##  #  #     #
####       ##     #  ##  #
## #       ##          # #
#           #         2  #
#                    ### #
##########################
