33 34
#################################
#      #  #    2  #             #
#                  #            #
#   #   #   #     # #           #
#                  #            #
#                  #     ##     #
#                    # ##       #
#  #                            #
#        #             #        #
#                   #           #
#       #  #                    #
#                   #           #
#               # #           # #
#            #                  #
# #     #                       #
#                      #        #
#   #    #      #     #    #   ##
##   #    #     #      #    #   #
#        #                      #
#                       #     # #
#                  #            #
# #           # #               #
#           #                   #
#                    #  #       #
#           #                   #
#        #             #        #
#                            #  #
#       ## #                    #
#     ##     #                  #
#            #                  #
#           # #     #   #   #   #
#            #                  #
#             #  1    #  #      #
#################################
