24 19
########################
# #    # #            ##
#  ##                # #
#   #                  #
#        #         #   #
#                      #
#     ##        1   #  #
#    #                 #
#         # #          #
#        #    #        #
#          # #         #
#                 #    #
#  #   2        ##     #
#                      #
#   #         #        #
#                  #   #
# #                ##  #
##            # #    # #
########################
