17 22
#################
#  #    #       #
#1       #    # #
#       #     # #
#   ## #   #  ###
#               #
##  #           #
# #       ###   #
#               #
# #             #
##          #   #
#   #          ##
#             # #
#               #
#   ###       # #
#           #  ##
#               #
###  #   # ##   #
# #     #       #
# #    #       2#
#       #    #  #
#################
