20 47
####################
#                  #
#       #   #      #
#   #     #       ##
#                  #
#   #              #
#         #        #
#                  #
#       #    ##    #
#  ## #  #         #
#    #   #         #
#                  #
#        #      #  #
#         # #     ##
#   #      #       #
#             #    #
#        #       # #
# ##               #
# #         1      #
##     #           #
#  #               #
##                 #
#            #     #
#                  #
#     #            #
#                 ##
#               #  #
#           #     ##
#      2         # #
#               ## #
# #       #        #
#    #             #
#       #      #   #
##     # #         #
#  #      #        #
#                  #
#         #   #    #
#         #  # ##  #
#    ##    #       #
#                  #
#        #         #
#              #   #
#                  #
##       #     #   #
#      #   #       #
#                  #
####################
