47 22
###############################################
#       ##      ##                     #      #
#                    # #  # # #               #
#   #            #   #  #            #      # #
#                                 #           #
#           #    #        #   #              ##
# #     #   2           # #         #    #   ##
#       #                           #         #
#               #    #                  #     #
#    #           #                            #
#          # #  ##                       #   ##
##   #                       ##  # #          #
#                            #           #    #
#     #                  #    #               #
#         #                           #       #
##   #    #         # #           1   #     # #
##              #   #        #    #           #
#           #                                 #
# #      #            #  #   #            #   #
#               # # #  # #                    #
#      #                     ##      ##       #
###############################################
