35 30
###################################
#        #  #         #         # #
#         # #            #        #
##       #             #          #
#       #       #                 #
#         #  #                    #
#              1                  #
#   #  ##        #       #     #  #
#              ##      #   ##     #
#           #     #      #  ##    #
#  #                    #     #   #
##          #                     #
#                      ##         #
#  #  #                           #
#      #      #               #   #
#   #               #      #      #
#                           #  #  #
#         ##                      #
#                     #          ##
#   #     #                    #  #
#    ##  #      #     #           #
#     ##   #      ##              #
#  #     #       #        ##  #   #
#                  2              #
#                    #  #         #
#                 #       #       #
#          #             #       ##
#        #            # #         #
# #         #         #  #        #
###################################
