24 17
########################
#             #        #
#       #      #       #
#       #            # #
#   #  #               #
##                  #  #
#     ##   ##          #
#  1  #         #      #
# #                  # #
#      #         #  2  #
#          ##   ##     #
#  #                  ##
#               #  #   #
# #            #       #
#       #      #       #
#        #             #
########################
