33 40
#################################
# # #  ## #  # #     #    #    ##
#  #   #       #    #     #   ###
#     #              #        # #
#          #  #  #    #    #   ##
#     #    #     ##      #    # #
#     #     #  #        #    #  #
##           # # ###  # #      ##
##  #     # # ## ####         ###
#    #    #            #        #
#       #  ## #          #   # ##
##          #  #  ##  #         #
## #       ##   #      #     #  #
# ##                   #        #
#  #   # #      #     # #   #   #
# #    #   # #      # #         #
# ### #   ##     # ##  #    #   #
# # #         ##        #  #  ###
##   #       # ## #        2## ##
#       #  ##      # # #        #
#        # # #      ##  #       #
## ##1        # ## #       #   ##
###  #  #        ##         # # #
#   #    #  ## #     ##   # ### #
#         # #      # #   #    # #
#   #   # #     #      # #   #  #
#        #                   ## #
#  #     #      #   ##       # ##
#         #  ##  #  #          ##
## #   #          # ##  #       #
#        #            #    #    #
###         #### ## # #     #  ##
##      # #  ### # #           ##
#  #    #        #  #     #     #
# #    #      ##     #    #     #
##   #    #    #  #  #          #
# #        #              #     #
###   #     #    #       #   #  #
##    #    #     # #  # ##  # # #
#################################
