22 19
######################
#           #  #     #
#    #  #          # #
#   1      #         #
#                  # #
##                 # #
#      #       ##    #
#                #  ##
#      ##            #
#    #          #    #
#            ##      #
##  #                #
#    ##       #      #
# #                 ##
# #                  #
#         #      2   #
# #          #  #    #
#     #  #           #
######################
