32 21
################################
##              #              #
#   # #  1    #   #            #
# #     #      #               #
#                              #
#                           #  #
##                   #        ##
#                    #         #
#                  #     #   # #
#     #    #         #         #
#       ##            ##       #
#         #         #    #     #
# #   #     #                  #
#         #                    #
##        #                   ##
#  #                           #
#                              #
#               #      #     # #
#            #   #    2  # #   #
#              #              ##
################################
