20 15
####################
#      #         # #
#     # #          #
#      #           #
#               #  #
## #      # #      #
#       1       #  #
#                  #
#  #       2       #
#      # #      # ##
#  #               #
#           #      #
#          # #     #
# #         #      #
####################
