23 16
#######################
#                     #
#        #         #  #
#     ##      #       #
#           #      #  #
#   #             #   #
#       ## #          #
# # #      1##  # #   #
#   # #  ##2      # # #
#          # ##       #
#   #             #   #
#  #      #           #
#       #      ##     #
#  #         #        #
#                     #
#######################
