21 50
#####################
# #    #  # #       #
#      #            #
#                  ##
#                   #
#  # #    #        ##
#        #      #   #
#         #         #
#     #     ##     ##
#               #   #
#       #   #      ##
# #             #   #
#     #             #
#             #     #
#       #        #  #
#      #         #  #
# #     #          ##
##                  #
#  #        #  #    #
#         #         #
##  #     #         #
#  #  #  # # #     ##
#                   #
#         #    #2   #
#     #    #        #
#        #    #     #
#   1#    #         #
#                   #
##     # # #  #  #  #
#         #     #  ##
#         #         #
#    #  #        #  #
#                  ##
##          #     # #
#  #         #      #
#  #        #       #
#     #             #
#             #     #
#   #             # #
##      #   #       #
#   #               #
##     ##     #     #
#         #         #
#   #      #        #
##        #    # #  #
#                   #
##                  #
#            #      #
#       # #  #    # #
#####################
