24 19
########################
#     #                #
#  #     #       #     #
#           #   #   #  #
#       #   #          #
#   # # # #   #   #    #
##    #    #    #2    ##
#      #  #    #  #   ##
#  ###    #   #  # #  ##
# #       #  #       # #
##  # #  #   #    ###  #
##   #  #    #  #      #
##    1#    #    #    ##
#    #   #   # # # #   #
#          #   #       #
#  #   #   #           #
#     #       #     #  #
#                #     #
########################
