16 19
################
##             #
#  #         2 #
#              #
#             ##
#            # #
#         #  # #
#     #        #
# # #   #      #
#              #
#      #   # # #
#        #     #
# #  #         #
# #            #
##             #
#              #
# 1         #  #
#             ##
################
