44 21
############################################
#                            #           # #
##  ##    #                         #   # ##
#        ##       #  #                 #   #
#       #    #                       #  ## #
#    #     #  #  #       #           #     #
#                       #                  #
#                 #       1   #      #     #
#         #             #  #     #   #     #
#     # ##                                 #
#  #           #    #  #    #           #  #
#                                 ## #     #
#     #   #     #  #             #         #
#     #      #   2       #                 #
#                  #                       #
#     #           #       #  #  #     #    #
# ##  #                       #    #       #
#   #                 #  #       ##        #
## #   #                         #    ##  ##
# #           #                            #
############################################
