19 26
###################
#   #     ##      #
# ##      ##      #
#    #1# #   #   ##
# ##    #       # #
#   #  ###       ##
#  #  #  # #    # #
#           #  ## #
# # ## #     #    #
#    #    # # #   #
##   #     ###   ##
##   #  #  #     ##
#  ###          # #
# #          ###  #
##     #  #  #   ##
##   ###     #   ##
#   # # #    #    #
#    #     # ## # #
# ##  #           #
# #    # #  #  #  #
##       ###  #   #
# #       #    ## #
##   #   # #2#    #
#      ##      ## #
#      ##     #   #
###################
