19 18
###################
#  # ##     # #   #
#               # #
#  #   #  ## ### ##
#             # # #
##        #   #  ##
#2  #   ##    # # #
#              #  #
###  ###  ### # # #
# # # ###  ###  ###
#  #              #
# # #    ##   #  1#
##  #   #        ##
# # #             #
## ### ##  #   #  #
# #               #
#   # #     ## #  #
###################
