48 19
################################################
#        1    ##  #         #     #      ## #  #
##     #    #      #     #    ## ##   #     # ##
#                       #     #    #       #   #
##    # #   #   ##      ##  #  ##              #
###         #             #              ##    #
#        #  #      #             ##    #  #  # #
# # #         ##      #     ##    # #  ##   ####
#   #           #   #       #            #    ##
##            #   ###      ###   #            ##
##    #            #       #   #           #   #
####   ##  # #    ##     #      ##         # # #
# #  #  #    ##             #      #  #        #
#    ##              #             #         ###
#              ##  #  ##      ##   #   # #    ##
#   #       #    #     #                       #
## #     #   ## ##    #     #      #    #     ##
#  # ##      #     #         #  ##    2        #
################################################
