50 27
##################################################
#   1   #          #        #                   ##
#     #       #    #                  #          #
#  #       #   #     #              #  #         #
##         #     #           #                   #
#      ##      #                                 #
#                                                #
#                  # # # ##                      #
#   #       #         #    #    ## #             #
#                                 #             ##
# #                     #            #           #
#           #                     # #       #    #
#                    #          #                #
#     #   #           #    #           #   #     #
#                #          #                    #
#    #       # #                     #           #
#           #            #                     # #
##             #                                 #
#             # ##    #    #         #       #   #
#                      ## # # #                  #
#                                                #
#                                 #      ##      #
#                   #           #     #         ##
#         #  #              #     #   #       #  #
#          #                  #    #       #     #
##                   #        #          #   2   #
##################################################
