30 35
##############################
##  #   #                    #
#  #   # #     #            ##
##             #             #
#                            #
#   #         #          #   #
#              #          #  #
#       #                    #
#              # #           #
#         #             #    #
#         1     #          # #
#                           ##
#                            #
#                            #
#    # #            #   # #  #
# #                          #
# #     #          #         #
##            ##            ##
#         #          #     # #
#                          # #
#  # #   #            # #    #
#                            #
#                            #
##                           #
# #          #     2         #
#    #             #         #
#           # #              #
#                    #       #
#  #          #              #
#   #          #         #   #
#                            #
#             #             ##
##            #     # #   #  #
#                    #   #  ##
##############################
