22 15
######################
#  #     #       #  ##
#  #   #   ##   ## ###
#       #      #    ##
#     #           #  #
## ##    #   2  #  # #
#               #    #
#                    #
#    #               #
# #  #  1   #    ## ##
#  #           #     #
##    #      #       #
### ##   ##   #   #  #
##  #       #     #  #
######################
