25 30
#########################
#      #   #     #      #
#           #           #
#   #         #         #
#      #              # #
#      #       #        #
#   #2    #         #   #
# #           #         #
# #                     #
#              #        #
# #    #      #      #  #
#   #          #   #    #
#        #   #          #
##                      #
#         ##            #
#            ##         #
#                      ##
#          #   #        #
#    #   #          #   #
#  #      #      #    # #
#        #              #
#                     # #
#         #           # #
#   #         #    1#   #
#        #       #      #
# #              #      #
#         #         #   #
#           #           #
#      #     #   #      #
#########################
