32 15
################################
#  # #      ###         ##     #
#  # #     #     #  #     #    #
#  # #      #  ## # #    #     #
#    2            #   #       ##
#      #         # # ##        #
#      ##    #   #  #      ### #
#       #              #       #
# ###      #  #   #    ##      #
#        ## # #         #      #
##       #   #            1    #
#     #    # # ##  #      # #  #
#    #     #  #     #     # #  #
#     ##         ###      # #  #
################################
