44 41
############################################
# #  # #       # #  #  #      # ##        ##
# ###      #    #       #  #    #    #   ###
#    #      #            #   ##      ##   ##
#     ##     #              #      1   #   #
#       ## #  #    #    #            #  #  #
#       #    #        #     ##  # #  #     #
#    #       #        #          #   #    ##
#      #  #      # #   ### #    #   #      #
##                 #  ## #  #     #   # #  #
#  ##    #   # #    ####     #        # ## #
## #    ## ##  #    #       #        ##    #
#         ##     #    #        #  #      # #
#      #  #  # #        # #  # #      #  # #
##  # #    #           #           ##    ###
#      #      #   #  #     # #  #   #      #
#      #  #    ##     #     #    ##   #  ###
#  #   #   #   #  #    # #             #   #
###                 ##       #             #
# #   ## ##    #   # # #  #  #   #   #     #
#  ##      ##   #          #   ##      ##  #
#     #   #   #  #  # # #   #    ## ##   # #
#             #       ##                 ###
#   #             # #    #  #   #   #   #  #
###  #   ##    #     #     ##    #  #      #
#      #   #  # #     #  #   #      #      #
###    ##           #           #    # #  ##
# #  #      # #  # #        # #  #  #      #
# #      #  #        #    #     ##         #
#    ##        #       #    #  ## ##    # ##
# ## #        #     ####    # #   #    ##  #
#  # #   #     #  # ##  #                 ##
#      #   #    # ###   # #      #  #      #
##    #   #          #        #       #    #
#     #  # #  ##     #        #    #       #
#  #  #            #    #    #  # ##       #
#   #   2      #              #     ##     #
##   ##      ##   #            #      #    #
###   #    #    #  #       #    #      ### #
##        ## #      #  #  # #       # #  # #
############################################
