18 21
##################
## #      #      #
#  #  #    #     #
#          ##    #
#  #  #       # ##
#  # #    #      #
#   #    #     2##
#   #       #    #
#     #  #       #
#    #    #   #  #
# # #        # # #
#  #   #    #    #
#       #  #     #
#    #       #   #
##1     #    #   #
#      #    # #  #
## #       #  #  #
#    ##          #
#     #    #  #  #
#      #      # ##
##################
