18 23
##################
##           #  ##
#   #         #  #
## 2           # #
#    #           #
## #           # #
#        #      ##
#             #  #
#                #
#  # #   #      ##
#         #  #   #
#   #        #   #
#   #  #         #
##      #   # #  #
#                #
#  #             #
##      #        #
# #           # ##
#           #    #
# #           1 ##
#  #         #   #
##  #           ##
##################
