33 38
#################################
#    # #                        #
#                ##     #       #
#  #         #           #      #
#                   #         ###
#          #   #                #
#    #                   #      #
#                #              #
#       #                       #
#                       #   # # #
# #     #        #             ##
#  #   #         #  #           #
#                               #
#    #                    #     #
#        #     1            #   #
#                           #   #
#            # #   #       #    #
#   #     # #                   #
#     #                         #
#                         #     #
#                   # #     #   #
#    #       #   # #            #
#   #                           #
#   #            2     #        #
#     #                    #    #
#                               #
#           #  #         #   #  #
##             #        #     # #
# # #   #                       #
#                       #       #
#              #                #
#      #                   #    #
#                #   #          #
###         #                   #
#      #           #         #  #
#       #     ##                #
#                        # #    #
#################################
