17 18
#################
#      # #  # # #
#           #   #
#2              #
##      #       #
####  #      #  #
#    # #   #    #
#        #      #
#   #           #
#           #   #
#      #        #
#    #   # #    #
#  #      #  ####
#       #      ##
#              1#
#   #           #
# # #  # #      #
#################
