43 22
###########################################
#          ##       #     #               #
#                    #    #               #
#  #        ## #   #                      #
#  #      #          #   # #  ##  #       #
#    ##            ##      #    #         #
#      #    #             #      #  # #   #
#    ##  #   #                 #         ##
#    #     #            ##  #     # #  #  #
# #  ##       #                           #
# #                             #        2#
#1        #                             # #
#                           #       ##  # #
#  #  # #     #  ##            #     #    #
##         #                 #   #  ##    #
#   # #  #      #             #    #      #
#         #    #      ##            ##    #
#       #  ##  # #   #          #      #  #
#                      #   # ##        #  #
#               #    #                    #
#               #     #       ##          #
###########################################
