38 17
######################################
#       #   #          #  #   #      #
#         #  #      # ###     #   ####
#      #            #                #
#            #                 ##    #
#    #              #     1 ##     # #
#               # #      #           #
#                                 #  #
#         # ## #      # ## #         #
#  #                                 #
#           #      # #               #
# #     ## 2     #              #    #
#    ##                 #            #
#                #            #      #
####   #     ### #      #  #         #
#      #   #  #          #   #       #
######################################
