24 35
########################
# #  #   #     #    #  #
##  #     # # # ##     #
#              #       #
# # #   #         #    #
#                  # # #
##   #         ##   # ##
#    #       #   ## ## #
#                      #
#         #  #       # #
###  #      ###  ### # #
# # # #     ## ## # #  #
#     #   # # # # #    #
#      #           ##  #
#    #      #          #
##     ##       #      #
# 2                  # #
#     #          #     #
# #                  1 #
#      #       ##     ##
#          #      #    #
#  ##           #      #
#    # # # # #   #     #
#  # # ## ##     # # # #
# # ###  ###      #  ###
# #       #  #         #
#                      #
# ## ##   #       #    #
## #   ##         #   ##
# # #                  #
#    #         #   # # #
#       #              #
#     ## # # #     #  ##
#  #    #     #   #  # #
########################
