50 31
##################################################
#  #           #        #   #      #   #   #     #
#   #                 #              #       #   #
#  #  #                   1                      #
#      #        #                                #
#      #         #       ###   ##               ##
#  #               #       ##    #   #           #
#    ##   #         #      #      #            # #
#               #       #           #            #
#               #      #                     #   #
# #          #                 #                 #
#     #                  #      #                #
#       #    #  #         #       #              #
#                              #               # #
#               #                      ##  # # # #
#                #              #                #
# # # #  ##                      #               #
# #               #                              #
#              #       #         #  #    #       #
#                #      #                  #     #
#                 #                 #          # #
#   #                     #      #               #
#            #           #       #               #
# #            #      #      #         #   ##    #
#           #   #    ##       #               #  #
##               ##   ###       #         #      #
#                                #        #      #
#                      2                   #  #  #
#   #       #              #                 #   #
#     #   #   #      #   #        #           #  #
##################################################
