49 40
#################################################
#            #  #             #         #       #
##     #   #                                    #
#       #            #            #       #     #
#          #             #           #    # #   #
#                   #        #       #          #
#         # #  #            #                   #
# #                      #                      #
#                         # # #    # #          #
#                   #        #                  #
#                           #     #             #
# #                               #  #          #
# ##                                #   #       #
#               #       #                       #
#  ##                            #              #
#     #         #                 #      #      #
#                                #       #    ###
#          #          #           #     #       #
#         # #     1        #                    #
#              #      #             #           #
#           #             #      #              #
#                    #        2     # #         #
#       #     #           #          #          #
###    #       #                                #
#      #      #                 #         #     #
#              #                            ##  #
#                       #       #               #
#       #   #                                ## #
#          #  #                               # #
#             #     #                           #
#                  #        #                   #
#          # #    # # #                         #
#                      #                      # #
#                   #            #  # #         #
#          #       #        #                   #
#   # #    #           #             #          #
#     #       #            #            #       #
#                                    #   #     ##
#       #         #             #  #            #
#################################################
