18 21
##################
# # #  #         #
#                #
# ##             #
#  # #           #
##  1   ##    ## #
##      #       ##
# #       # #  # #
#      ##        #
#          #  #  #
##  #        #  ##
#  #  #          #
#        ##      #
# #  # #       # #
##       #      ##
# ##    ##   2  ##
#           # #  #
#             ## #
#                #
#         #  # # #
##################
