15 16
###############
##   ## ##    #
#    #    #   #
#    #  #     #
## 2 #   #  # #
#    #  #   # #
## #  # #    ##
#         #  ##
##  #         #
##    # #  # ##
# #   #  #    #
# #  #   # 1 ##
#     #  #    #
#   #    #    #
#    ## ##   ##
###############
