37 40
#####################################
#           #                #      #
#   #                               #
#                     #        # #  #
#         #        # #      ##      #
#    ##   #   #                     #
##                     ##1  #       #
#          #   #      #   #         #
#                                   #
#                     #             #
#     #                             #
#                        #     #    #
#    # #                     #      #
# #                                 #
##                                  #
### #             #      #    #     #
#            #           #       #  #
#                      #    #       #
#    #           ##               # #
#        ##        #     #    #     #
#     #    #     #        ##        #
# #               ##           #    #
#       #    #                      #
#  #       #           #            #
#     #    #      #             # ###
#                                  ##
#                                 # #
#      #                     # #    #
#    #     #                        #
#                             #     #
#             #                     #
#                                   #
#         #   #      #   #          #
#       #  2##                     ##
#                     #   #   ##    #
#      ##      # #        #         #
#  # #        #                     #
#                               #   #
#      #                #           #
#####################################
