39 34
#######################################
#           #        #                #
# #     #       #     #  #            #
#  #       #                        # #
#     #                          ##   #
#      # #           2      #         #
#                # #        #         #
#             #   #       #           #
###    # #       ##                  ##
# # #  #                #   #   #  #  #
##   #         # #            #       #
#   #   #    #     #     ##    #      #
#    #        # ##  #      ##         #
#       #         # #  #        #    ##
#        #            #    ##         #
#            #    #             #    ##
# #     #     ##         ###       #  #
#  #       ###         ##     #     # #
##    #             #    #            #
#         ##    #            #        #
##    #        #  # #         #       #
#         ##      #  ## #        #    #
#      #    ##     #     #    #   #   #
#       #            # #         #   ##
#  #  #   #   #                #  # # #
##                  ##       # #    ###
#           #       #   #             #
#         #        # #                #
#         #      1           # #      #
#   ##                          #     #
# #                        #       #  #
#            #  #     #       #     # #
#                #        #           #
#######################################
