23 18
#######################
# #       #     #  # ##
#  #     #         #  #
#       #      #     ##
#       #          #  #
##     #    #         #
# #2 # #       # #    #
#   #             #   #
#          #   #      #
#      #   #          #
#   #             #   #
#    # #       # # 1# #
#         #    #     ##
#  #          #       #
##     #      #       #
#  #         #     #  #
## #  #     #       # #
#######################
