17 16
#################
#    #### # #   #
#             # #
##          # ###
##      #       #
##   #          #
#    #  1     # #
#        #      #
#      #        #
# #     2  #    #
#          #   ##
#       #      ##
### #          ##
# #             #
#   # # ####    #
#################
