33 24
#################################
#  # #         ###       #     ##
##             #   # #    #  ## #
#         ##      #          # ##
#  #  ## #                   #  #
#      # #         #    #       #
#     #   #       #  ##       # #
#  2    #                       #
#         #                    ##
#               #  #      #     #
#      ##       # ##   #        #
##      #         #   #        ##
##        #   #         #      ##
#        #   ## #       ##      #
#     #      #  #               #
##                    #         #
#                       #    1  #
# #       ##  #       #   #     #
#       #    #         # #      #
#  #                   # ##  #  #
## #          #      ##         #
# ##  #    # #   #             ##
##     #       ###         # #  #
#################################
