16 25
################
#   #   #      #
##          # ##
##       #     #
#      2       #
#           #  #
##           ###
##  # #       ##
#  # ##      # #
#          # # #
#   # #        #
#              #
#  # # ## # #  #
#              #
#        # #   #
# # #          #
# #      ## #  #
##       # #  ##
###           ##
#  #           #
#       1      #
#     #       ##
## #          ##
#      #   #   #
################
