16 21
################
#  ##    #  #  #
#         ## ###
#1     ## #    #
#       #     ##
#     ##     # #
#              #
#        #   # #
##    # # ##   #
#   ##  #     ##
#  # #    # #  #
##     #  ##   #
#   ## # #    ##
# #   #        #
#              #
# #     ##     #
##     #       #
#    # ##     2#
### ##         #
#  #  #    ##  #
################
