26 23
##########################
#            #           #
#    #    # #            #
#  #      #              #
#        #               #
#       #      #         #
#    #    #              #
#        #       #       #
#        #   #       #   #
#    # 1           #     #
#  #         #           #
# #                    # #
#           #         #  #
#     #           2 #    #
#   #       #   #        #
#       #       #        #
#              #    #    #
#         #      #       #
#               #        #
#              #      #  #
#            # #    #    #
#           #            #
##########################
