21 38
#####################
# #     #           #
#    ##   #    #    #
#   #    # #    #   #
# #  #    # # ##    #
#   #      #        #
#1 #  ##    ##     ##
# #         #    #  #
#      #     ##     #
#   #             # #
# ##   #    #       #
#     #   # #     # #
#        #      #   #
#  #        #       #
# #     #           #
#    #     #        #
#  ##   #   #  ##   #
#     #       #    ##
#                   #
#                   #
##    #       #     #
#   ##  #   #   ##  #
#        #     #    #
#           #     # #
#       #        #  #
#   #      #        #
# #     # #   #     #
#       #    #   ## #
# #             #   #
#     ##     #      #
#  #    #         # #
##     ##    ##  # 2#
#        #      #   #
#    ## # #    #  # #
#   #    # #    #   #
#    #    #   ##    #
#           #     # #
#####################
