20 21
####################
#         #        #
# ##        ##     #
#        ##        #
#              2   #
#                  #
#           #      #
# #    #           #
#   #  #           #
#       #          #
###     #  #     ###
#          #       #
#           #  #   #
#           #    # #
#      #           #
#                  #
#   1              #
#        ##        #
#     ##        ## #
#        #         #
####################
