17 50
#################
#      #        #
#    #     #  # #
#         #     #
## #            #
#       #       #
#    #          #
#               #
#         # #   #
#  #      #     #
#               #
# #            ##
#      ##1 #    #
#          # ## #
##   # #    #  ##
#   #           #
##     #        #
#          #    #
#               #
#   #           #
#   #       #   #
#  #            #
#           #   #
#             # #
#     #  # ##   #
#   ## #  #     #
# #             #
#   #           #
#            #  #
#   #       #   #
#           #   #
#               #
#    #          #
#        #     ##
#           #   #
##  #    # #   ##
# ## #          #
#    # 2##      #
##            # #
#               #
#     #      #  #
#   # #         #
#               #
#          #    #
#       #       #
#            # ##
#     #         #
# #  #     #    #
#        #      #
#################
