20 25
####################
#              ##  #
##                ##
# #        #    #  #
#  #         #     #
##   #         # # #
##   #          2  #
#      #   #  #    #
#                  #
# #         #      #
#                  #
# #    #           #
#                  #
#           #    # #
#                  #
#      #         # #
#                  #
#    #  #   #      #
#  1          #   ##
# # #         #   ##
#     #         #  #
#  #    #        # #
##                ##
#  ##              #
####################
