15 22
###############
##  #   #  #  #
#    # #      #
##     # #    #
#         #   #
#             #
#             #
#   2         #
#       # #   #
#       #     #
#  #          #
#          #  #
#     #       #
#   # #       #
#         1   #
#             #
#             #
#   #         #
#    # #     ##
#      # #    #
#  #  #   #  ##
###############
