41 22
#########################################
#  #   #    ##  #                  ## # #
##         ###   #       #          #   #
#   ##           #   #      ##          #
# ##  #        #         #             ##
# ##  #   #        #    #      # ##  ## #
### ## #    #         #  #   1  #  #    #
#       ##  #   # #             ## #    #
# ##      #  #   #     # #        ## #  #
#    ###     #    ##              ##    #
#   #  #     #            #        # ## #
# ## #        #            #     #  #   #
#    ##              ##    #     ###    #
#  # ##        # #     #   #  #      ## #
#    # ##             # #   #  ##       #
#    #  #  2   #  #         #    # ## ###
# ##  ## #      #    #        #   #  ## #
##             #         #        #  ## #
#          ##      #   #           ##   #
#   #          #       #   ###         ##
# # ##                  #  ##    #   #  #
#########################################
