24 15
########################
## # #  # #  ##     # ##
###   #     #    #  #  #
### ## # #       ##    #
#  #     #             #
##1  # ## ##   #  # # ##
# # #  #     # ##      #
#  ##     #  #     ##  #
#      ## #     #  # # #
## # #  #   ## ## #  2##
#             #     #  #
#    ##       # # ## ###
#  #  #    #     #   ###
## #     ##  # #  # # ##
########################
