15 30
###############
#          #  #
#          # ##
#             #
# 1 #         #
#             #
#         #   #
#             #
# #         # #
#             #
##            #
#       #   # #
##      #     #
#           # #
##            #
#            ##
# #           #
#     #      ##
# #   #       #
#            ##
#             #
# #         # #
#             #
#   #         #
#             #
#         # 2 #
#             #
## #          #
#  #          #
###############
