42 21
##########################################
##       ##  # #   ###          ##    #  #
#          #                  #   #      #
#   # ## #  #         #    #   ##  #     #
#    #                  ##  ##   #    ## #
#  ###                   # #      ## #   #
####  ##   1 #     ##  # #      #        #
##        ##  #           #       #    # #
#   ## # #  ###        #     #    ##     #
#  #  #  ##  #  #    ## #####            #
#####         #            #         #####
#            ##### ##    #  #  ##  #  #  #
#     ##    #     #        ###  # # ##   #
# #    #       #           #  ##        ##
#        #      # #  ##     # 2   ##  ####
#   # ##      # #                   ###  #
# ##    #   ##  ##                  #    #
#     #  ##   #    #         #  # ## #   #
#      #   #                  #          #
#  #    ##          ###   # #  ##       ##
##########################################
