16 27
################
#    # #   # # #
##        ##  ##
# #            #
###  #   # 1   #
#  #      #  # #
#  #        #  #
###   #  #   # #
#             ##
#      #   #   #
#     # #     ##
#              #
# #            #
#              #
#            # #
#              #
##     # #     #
#   #   #      #
##             #
# #   #  #   ###
#  #        #  #
# #  #      #  #
#   2 #   #  ###
#            # #
##  ##        ##
# # #   # #    #
################
