15 24
###############
##        #  ##
#     ##     ##
#        #    #
#         # # #
#    1        #
#             #
#    #     #  #
#             #
## #      #   #
#    #        #
#             #
#             #
#        #    #
#   #      # ##
#             #
#  #     #    #
#             #
#        2    #
# # #         #
#    #        #
##     ##     #
##  #        ##
###############
