23 20
#######################
#         #        #  #
#        #           ##
#           #     #   #
#  #            #     #
#    #   #     #      #
#       1  #          #
#           #         #
#    #                #
#    #                #
#                #    #
#                #    #
#         #           #
#          #  2       #
#      #     #   #    #
#     #            #  #
#   #     #           #
##           #        #
#  #        #         #
#######################
