22 43
######################
#      #   ## #  #   #
#       ##      ##  ##
#                  # #
#                  # #
# ##  #       # ## # #
#   #    ##          #
#      #   # ##      #
##     #  ##         #
#  #    # #    #    ##
#                    #
##   #      #      # #
#    #    #        # #
##       ##  #       #
#        #  #        #
#   #    #           #
#  ## #   #       #  #
#            #  ## # #
#        #      ##  ##
##   #        # #    #
#1                  ##
##   #          #   ##
##                  2#
#    # #        #   ##
##  ##      #        #
# # ##  #            #
#  #       #   # ##  #
#           #    #   #
#        #  #        #
#       #  ##       ##
# #        #    #    #
# #      #      #   ##
#                    #
##    #    # #    #  #
#         ##  #     ##
#      ## #   #      #
#          ##    #   #
# # ## #       #  ## #
# #                  #
# #                  #
##  ##      ##       #
#   #  # ##   #      #
######################
