18 19
##################
##               #
#          #   # #
# #  #  #   # #  #
#  1 #    ##   # #
#     #    #    ##
##      # # #    #
#                #
#      #   #     #
#                #
#     #   #      #
#                #
#    # # #      ##
##    #    #     #
# #   ##    # 2  #
#  # #   #  #  # #
# #   #          #
#               ##
##################
