49 34
#################################################
#           #                     ##            #
#        #      #             #    #    #       #
# #    #          # #                           #
#  #  #       ## #     # #   #    #             #
#       1         #     ##                      #
#                     # # #        #            #
#   #            #  # #                ##  ##   #
#    # #   #                   #               ##
#            # #            #     #             #
#  #                    #    #    #     #       #
#   #             #    # #        #             #
#                                               #
#                   #         #           #    ##
#                  #  #     #     ##            #
#    #  ##    #                #     #          #
#          #         #  ###                     #
#                     ###  #         #          #
#          #     #                #    ##  #    #
#            ##     #     #  #                  #
##    #           #         #                   #
#                                               #
#             #        # #    #             #   #
#       #     #    #    #                    #  #
#             #     #            # #            #
##               #                   #   # #    #
#   ##  ##                # #  #            #   #
#            #        # # #                     #
#                      ##     #         2       #
#             #    #   # #     # ##       #  #  #
#                           # #          #    # #
#       #    #    #             #      #        #
#            ##                     #           #
#################################################
