45 18
#############################################
#     #           #      #               ## #
#  # #      #   # #     #   #   ###         #
#         # # ## #   #   #  #        ##  ## #
## # #  ##      ### # ## #       #         ##
#  #       #  ### #  #  #   #  #   ##       #
#   #    #   #  #      #     ## ##          #
####  ##  #   #       ## ####    1  ## ##   #
### # ##  #            #     #       ###    #
#    ###       #     #            #  ## # ###
#   ## ##  2    #### ##       #   #  ##  ####
#          ## ##     #      #  #   #    #   #
#       ##   #  #   #  #  # ###  #       #  #
##         #       # ## # ###      ##  # # ##
# ##  ##        #  #   #   # ## # #         #
#         ###   #   #     # #   #      # #  #
# ##               #      #           #     #
#############################################
