35 22
###################################
###              #            #   #
#      #       # #        #       #
#  #                  #     #     #
# # #  # #        # # #    #      #
#                ##   #           #
##           #          #    #    #
# #             #     #   ##   #  #
#         #   #       #          ##
#       # ###      #  #  #     #  #
#     #          1  #  #          #
#          #  #  2          #     #
#  #     #  #  #      ### #       #
##          #       #   #         #
#  #   ##   #     #             # #
#    #    #          #           ##
#           #   ##                #
#      #    # # #        # #  # # #
#     #     #                  #  #
#       #        # #       #      #
#   #            #              ###
###################################
