16 35
################
#      ###   # #
##    ## #     #
#              #
#  #           #
#              #
#  ###   # ### #
#   # # # 2    #
##  ### #      #
##   #         #
#     #      # #
##             #
#      # #     #
##         # # #
# #        ## ##
#   #  #   #   #
### #   ##    ##
# #          # #
##    ##   # ###
#   #   #  #   #
## ##        # #
# # #         ##
#     # #      #
#             ##
# #      #     #
#         #   ##
#      # ###  ##
#    1 # # #   #
# ### #   ###  #
#              #
#           #  #
#              #
#     # ##    ##
# #   ###      #
################
