27 22
###########################
#      #          #  # #  #
#      ## # #  # #     #  #
##    1   #  #   #  #     #
##  #        ##           #
# #    #  #  #        #   #
# ##  ##  # # #      #    #
#             #  # # #    #
##        #   # # ## #    #
#     ## #   # #     #    #
##  #      # #         #  #
#  #         # #      #  ##
#    #     # #   # ##     #
#    # ## # #   #        ##
#    # # #  #             #
#    #      # # #  ##  ## #
#   #        #  #  #    # #
#           ##        #  ##
#     #  #   #  #   2    ##
#  #     # #  # # ##      #
#  # #  #          #      #
###########################
