22 15
######################
#    ##  #  #        #
#          #         #
##     # #      1 # ##
#  #    #           ##
#   #                #
#  # #               #
#      #      #      #
#               # #  #
#                #   #
##           #    #  #
## # 2      # #     ##
#         #          #
#        #  #  ##    #
######################
