46 23
##############################################
#    #           #    #                      #
#        #   # 1    #       #               ##
#                  #              #  #       #
#                                           ##
## # #                 #  #   #   #    #     #
#                     #  #    #   #     ##   #
#      #              #                      #
#            #            #   #              #
##          # #   #         #   #        #  ##
# #                  #                     ###
#         ##    #            #    ##         #
###                     #                  # #
##  #        #   #         #   # #          ##
#              #   #            #            #
#                      #              #      #
#   ##     #   #    #  #                     #
#     #    #   #   #  #                 # # ##
##                                           #
#       #  #              #                  #
##               #       #    2 #   #        #
#                      #    #           #    #
##############################################
