25 20
#########################
#       #  ##   ###     #
##  ##    2   ##     #  #
# #  # ## #     #       #
#      ## # #  # #  #   #
#         # #      # # ##
##    # #  #          # #
# #      #        #    ##
# #   #        #    #   #
#  #     #          #   #
#   #          #     #  #
#   #    #        #   # #
##    #        #      # #
# #          #  # #    ##
## # #      # #         #
#   #  # #  # # ##      #
#       #     # ## #  # #
#  #     ##   1    ##  ##
#     ###   ##  #       #
#########################
