20 35
####################
#    #     # #     #
#  #  ###   #      #
#                  #
#  #  ##        ## #
##  #        #  # ##
#             #  # #
#   #1 #        ####
#      #    #      #
#        #         #
#           #     ##
#  #    #      #   #
#  #       #      ##
# # #      # #    ##
#              # # #
#   #           ## #
#                # #
# #              # #
# #                #
# ##           #   #
# # #              #
##    # #      # # #
##      #       #  #
#   #      #    #  #
##     #           #
#         #        #
#      #    #      #
####        # 2#   #
# #  #             #
## #  #        #  ##
# ##        ##  #  #
#                  #
#      #   ###  #  #
#     # #     #    #
####################
