24 15
########################
#       # #    # #   # #
#         #       ##   #
#       #  #     #     #
#    ##                #
#   #           #    #2#
# #   ##    #         ##
# #   #  #    #  #   # #
##         #    ##   # #
#1#    #           #   #
#                ##    #
#     #     #  #       #
#   ##       #         #
# #   # #    # #       #
########################
