49 24
#################################################
#                                #   #    #     #
##      #   # #                  #         #    #
#    #     #                   #   2            #
#  #       #   #       #                 #      #
# ##    #             #    #                    #
#             #                                 #
#        #    ##                        # #     #
#                 #        #  #                 #
#       #                                       #
#                   #       #                #  #
#                  #       #                 ## #
# ##                 #       #                  #
#  #                #       #                   #
#                                       #       #
#                 #  #        #                 #
#     # #                        ##    #        #
#                                 #             #
#                    #    #             #    ## #
#      #                 #       #   #       #  #
#            1   #                   #     #    #
#    #         #                  # #   #      ##
#     #    #   #                                #
#################################################
