15 46
###############
#    #    #   #
#             #
#         ## ##
#       #     #
#     #     ###
#     #   #  ##
#  #          #
#  ##   # #   #
#  #        # #
# #    ##  #  #
##       #    #
#     #       #
#   #      #  #
#     #     # #
#      #      #
#    #   #    #
#  2          #
#            ##
#             #
# ##   #  ##  #
#            ##
#             #
#             #
##            #
#  ##  #   ## #
#             #
##            #
#          1  #
#    #   #    #
#      #      #
# #     #     #
#  #      #   #
#       #     #
#    #       ##
#  #  ##    # #
# #        #  #
#   # #   ##  #
#          #  #
##  #   #     #
###     #     #
#     #       #
## ##         #
#             #
#   #    #    #
###############
