38 27
######################################
#  #                 #               #
# #            # #                   #
#                     #           #  #
#                  #  # #  #         #
#        #            #            # #
#       #          #           #  #  #
#                               #    #
#    #      #             1          #
#    #    #         # ##  #          #
#         #                          #
#     #                #             #
#               #                   ##
##    #    #   #      #   #    #    ##
##                   #               #
#             #                #     #
#                          #         #
#          #  ## #         #    #    #
#          2             #      #    #
#    #                               #
#  #  #           #          #       #
# #            #            #        #
#         #  # #  #                  #
#  #           #                     #
#                   # #            # #
#               #                 #  #
######################################
