32 39
################################
#    1      #        #    #    #
#         #   #             #  #
##       #   #                 #
#     #                        #
#      #   #              #  # #
#   #  ####         #  #     # #
# #                     ###  # #
#   #                          #
# #       #   ##              ##
# #    #                    ## #
#                  #        #  #
#      #                       #
# #                  #         #
#      # #    #        #       #
#    # #   #   #       #  #    #
#          #   #              ##
#   #            #  # #        #
# #   ##       #               #
#   #                      #   #
#               #       ##   # #
#        # #  #            #   #
##              #   #          #
#    #  #       #   #   # #    #
#       #        #    # #      #
#         #                  # #
#                       #      #
#  #        #                  #
# ##                    #    # #
##              ##   #       # #
#                          #   #
# #  ###                     # #
# #     #  #         ####  #   #
# #  #              #   #      #
#                        #     #
#                 #   #       ##
#  #             #   #         #
#    #    #        #      2    #
################################
