43 38
###########################################
# #     #   ## #  ## #  #            # ## #
#   #      #          #    #              #
#   #      #             #                #
## #            # #     #    ##   #   #   #
#   ###  #  ### #  # # # #           #   ##
#     #  #   # #   #           ##     #   #
#  #  # #  #  #   #  #     #      #       #
##  ##      ##     #   #     #            #
#  #     #  #  #   # #     #  ##  #       #
#    ##     # #  #     #  #   ##          #
# #     #           ##  #           #  #  #
# #  # #2##   # #   #    ##  ##  ## #   # #
#    #      ###  #       #         # #    #
#             #   #  #     #        ###   #
##    ## #  # ## ###          #     ### # #
#  ### ##                #  # #        #  #
#          #       #        # #  #   #    #
#         #       # ##  #   #   ## #     ##
##     # ##   #   #  ## #       #         #
#    #   #  # #        #       #          #
#  #        # #  #                ## ###  #
# # ###     #          ### ## #  # ##    ##
#   ###        #     #  #   #             #
#    # #         #       #  ###      #    #
# #   # ##  ##  ##    #   # #   ##1# #  # #
#  #  #           #  ##           #     # #
#          ##   #  #     #  # #     ##    #
#       #  ##  #     # #   #  #  #     #  #
#            #     #   #     ##      ##  ##
#       #      #     #  #   #  #  # #  #  #
#   #     ##           #   # #   #  #     #
##   #           # # # #  # ###  #  ###   #
#   #   #   ##    #     # #            # ##
#                #             #      #   #
#              #    #          #      #   #
# ## #            #  # ##  # ##   #     # #
###########################################
