22 21
######################
#  #               # #
#     #        #     #
#1              #    #
#          #   # #   #
#          #         #
###  #         #     #
#  #       #         #
# #    #    #    #   #
#                   ##
## #              # ##
##                   #
#   #    #    #    # #
#         #       #  #
#     #         #  ###
#         #          #
#   # #   #          #
#    #              2#
#     #        #     #
# #               #  #
######################
