32 41
################################
# #     ##         ##      #   #
#   #       #           #  #   #
#       #      #              ##
#                     #  ##    #
#   #                 #    #   #
#    #  ##                     #
#   #        #        #        #
#     #          #   #    #  # #
#                       ## #   #
#           #         ##  #    #
# #  #             #  # #      #
#                   # #        #
##   #    #  #    #            #
#   ##  #     #           #    #
#      #      ##     #         #
#  #  # #   #    #          #  #
#      # # #  #   #          # #
#        #   # # #    #        #
#        #         #        #  #
# #    1 #    #  #    # 2    # #
#  #        #         #        #
#        #    # # #   #        #
# #          #   #  # # #      #
#  #          #    #   # #  #  #
#         #     ##      #      #
#    #           #     #  ##   #
#            #    #  #    #   ##
#        # #                   #
#      # #  #             #  # #
#    #  ##         #           #
#   # ##                       #
# #  #    #   #          #     #
#        #        #        #   #
#                     ##  #    #
#   #    #                 #   #
#    ##  #                     #
##              #      #       #
#   #  #           #       #   #
#   #      ##         ##     # #
################################
