46 15
##############################################
#               #   #  #     #  #### # #  #  #
#  #  ##    # #  #    ##  # #     ##  #   # ##
# #    #  #   # #  ##      #         #  #   ##
# #  # # # ##          # #    #   ##      ## #
#     #       # #  # ##  #         #   #     #
#  #    #    #    ####             #       #1#
#         #      # #      # #      #         #
#2#       #             ####    #    #    #  #
#     #   #         #  ## #  # #       #     #
# ##      ##   #    # #          ## # # #  # #
##   #  #         #      ##  # #   #  #    # #
## #   #  ##     # #  ##    #  # #    ##  #  #
#  #  # # ####  #     #  #   #               #
##############################################
