17 24
#################
#  ## 2   #   # #
##          #   #
#        # #    #
#            # ##
#  ##        #  #
#    # #        #
#    #   #      #
#  #         ## #
#   ##          #
#  #   ## #  # ##
#           ##  #
#  ##           #
## #  # ##   #  #
#          ##   #
# ##         #  #
#      #   #    #
#        # #    #
#  #        ##  #
## #            #
#    # #        #
#   #          ##
# #   #   1 ##  #
#################
