25 30
#########################
#      #     ##     #   #
#             #       # #
#        #     #        #
# #   ##            #  ##
#    #   #       ##     #
#     #  #         #    #
#1#   ##    # ####      #
#            #   #   # ##
# # ##              #   #
#  #      # #    #      #
#  #     # #            #
#             #         #
#     # #              ##
#            # # ##   # #
# #   ## # #            #
##              # #     #
#         #             #
#            # #     #  #
#      #    # #      #  #
#   #              ## # #
## #   #   #            #
#      #### #    ##   #2#
#    #         #  #     #
#     ##       #   #    #
##  #            ##   # #
#        #     #        #
# #       #             #
#   #     ##     #      #
#########################
