26 21
##########################
#      #                 #
#                        #
#  #   #  #       #      #
##            #1         #
#  #                     #
#        #  #            #
# #              #    #  #
#            #   #       #
#    # ##        #       #
#                        #
#       #        ## #    #
#       #   #            #
#  #    #              # #
#            #  #        #
#                     #  #
#         2#            ##
#      #       #  #   #  #
#                        #
#                 #      #
##########################
