43 24
###########################################
#     #           #    #                 ##
#  # #         #      #         #     #   #
#     # #   #        2 #  #    #       ## #
# #         #   #       # #     #     #  ##
#    #       #   #   #  # #     #         #
#   #             #   ####      # #  ##   #
##         # ###   #        ##     #   #  #
#      ### ## #               #   #  # #  #
#   # # ### #   # #     #        #  # #   #
#  #    #    #  ##   # ## #          #    #
#     #    #    #     #        # #   #    #
#    #   # #        #     #    #    #     #
#    #          # ## #   ##  #    #    #  #
#   # #  #        #     # #   # ### # #   #
#  # #  #   #               # ## ###      #
#  #   #     ##        #   ### #         ##
#   ##  # #      ####   #             #   #
#         #     # #  #   #   #       #    #
##  #     #     # #       #   #         # #
# ##       #    #  # 1        #   # #     #
#   #     #         #      #         # #  #
##                 #    #           #     #
###########################################
