19 20
###################
#  #              #
# #              ##
#         2 #     #
#     #   #  #    #
#           #     #
#   # ##          #
#       #         #
#           #     #
#      #       #  #
#  #       #      #
#     #           #
#         #       #
#          ## #   #
#     #           #
#    #  #   #     #
#     # 1         #
##              # #
#              #  #
###################
