36 17
####################################
##       #   #    #      #         #
# ##                  #   #     #  #
#           #        #  ##         #
# ##     #  #   #     #    #  #    #
#   #     #          ##   #  #     #
# #               #  #        #    #
## #     #                2        #
#               #  #               #
#        1                #     # ##
#    #        #  #               # #
#     #  #   ##          #     #   #
#    #  #    #     #   #  #     ## #
#         ##  #        #           #
#  #     #   #                  ## #
#         #      #    #   #       ##
####################################
