19 20
###################
#        #     #1 #
#         #    ## #
#       # ##   #  #
# #      #     ## #
#    #         #  #
# ## #      ## #  #
#   #         #   #
#  #         # #  #
#    # #       # ##
## #       # #    #
#  # #         #  #
#   #         #   #
#  # ##      # ## #
#  #         #    #
# ##     #      # #
#  #   ## #       #
# ##    #         #
# 2#     #        #
###################
