45 46
#############################################
#   #        # #         ##             #  ##
### #           # #     # ###   #    #      #
#      #   #     #            # #          ##
#                    #   # ##               #
#   #   #        #    ##         #   #      #
##  #  ##    #   #    ##  #        ##     # #
#              #     # ##  #   #        # # #
# #    ##   #  #  #  ##      #     #        #
#     #         #   # # #  # #   #        # #
#      #    #        #   #  #         #     #
# #         #    #          #               #
#  #          #            # #  ## #     # ##
#        #          #     #     # #  # #    #
#  #  #        #    #        #    #         #
#                #  #        ##         #   #
#      #                       #   # #      #
#          #  #1     ##  #  #         # # ###
#            ##          ###        #  #    #
#          ## # #           #   #           #
#      ##### ###            #     #         #
#   ##     # # #                            #
#         #    #    #####             #     #
#     #             #####    #    #         #
#                            # # #     ##   #
#         #     #            ### #####      #
#           #   #           # # ##          #
#    #  #        ###          ##            #
### # #         #  #  ##     2#  #          #
#      # #   #                       #      #
#   #         ##        #  #                #
#         #    #        #    #        #  #  #
#    # #  # #     #     #          #        #
## #     # ##  # #            #          #  #
#               #          #    #         # #
#     #         #  #   #        #    #      #
# #        #   # #  # # #   #         #     #
#        #     #      ##  #  #  #   ##    # #
# # #        #   #  ## #     #              #
# #     ##        #  ##    #   #    ##  #  ##
#      #   #         ##    #        #   #   #
#               ## #   #                    #
##          # #            #     #   #      #
#      #    #   ### #     # #           # ###
##  #             ##         # #        #   #
#############################################
