45 38
#############################################
#       1  ##         #       #   #  #  #   #
#               # #                #   #    #
#               #                         # #
##          #    #   ##     #               #
#                                          ##
#        #             #        #      #    #
#                               #   ###  #  #
#                     #                #    #
##        #             #                  ##
# #                         #               #
##         #          #          #          #
#             #                        #   ##
#                          #            #   #
#         #    ###      #       #   #       #
#       #     #           # #    # #        #
##      #               # #                 #
#    #       #  #  # #      #      #        #
#         #           #    #              # #
# #              #    #           #         #
#        #      #      # #  #  #       #    #
#                 # #               #      ##
#        # #    # #           #     #       #
#       #   #       #      ###    #         #
#   #            #                          #
##   #                        #             #
#          #          #          #         ##
#               #                         # #
##                  #             #        ##
#    #                #                     #
#  #  ###   #                               #
#    #      #        #             #        #
##                                          #
#               #     ##   #    #          ##
# #                         #               #
#    #   #                # #               #
#   #  #  #   #       #         ##  2       #
#############################################
