34 23
##################################
#  ##      # # #          #      #
##     #    #        #   #       #
#             #                  #
#      # ##             1        #
##  #        #  #    # #     #  ##
#  #              #      #       #
#            #       ##    #     #
# #                              #
#                   #         #  #
#              #                 #
#       #    #      #    #       #
#                 #              #
#  #         #                   #
#                              # #
#     #    ##       #            #
#       #      #              #  #
##  #     # #    #  #        #  ##
#        2             ## #      #
#                  #             #
#       #   #        #    #     ##
#      #          # # #      ##  #
##################################
