16 21
################
#       #      #
# #2#    #     #
#         #    #
#      #   #   #
#           #  #
##           # #
#              #
#       #      #
# #      ##    #
##  ##    ##  ##
#    ##      # #
#      #       #
#              #
# #           ##
#  #           #
#   #   #      #
#    #         #
#     #    #1# #
#      #       #
################
