31 50
###############################
#  #  #   ## #   # #       # ##
##     #  #      #     # #1#  #
#  #            #           # #
#             #    #       ## #
##  #   #            # ##     #
#   #           ##  #  #  #   #
#       #    # #   #        ###
#         # ## #  #  ##  #    #
# #   #    #      ### ## #  # #
#      #  #  #  # #     #    ##
#     #                       #
##  ### # # #          #      #
##  ###   ##          #     ###
##  # ##           #  #    ## #
#       ##     #  ## #  #     #
#           #    #     ##   # #
# #   #   #         #      #  #
# ##  # #  #               ####
# ## #  # # #        #  # #   #
#   ##  #      # # #  #   #  ##
# ##                      ##  #
#    ### #       ##  #        #
#          #   ##        #    #
## # #           ##  #    # # #
# # #    #  ##           # # ##
#    #        ##   #          #
#        #  ##       # ###    #
#  ##                      ## #
##  #   #  # # #      #  ##   #
#   # #  #        # # #  # ## #
####               #  # #  ## #
#  #      #         #   #   # #
# #   ##     #    #           #
#     #  # ##  #     ##       #
# ##    #  #           ## #  ##
###     #          ##   ###  ##
#      #          # # # ###  ##
#                       #     #
##    #     # #  #  #  #      #
# #  # ## ###      #    #   # #
#    #  ##  #  # ## #         #
###        #   # #    #       #
#   #  #  #  ##           #   #
#     ## #            #   #  ##
# ##       #    #             #
# #           #            #  #
#  #2# #     #      #  #     ##
## #       # #   # ##   #  #  #
###############################
