22 19
######################
# #        #         #
#  # #   #           #
#  #                 #
# #         2        #
#             #  # # #
#             #      #
##                   #
# #                  #
#                    #
#                  # #
#                   ##
#      #             #
# # #  #             #
#        1         # #
#                 #  #
#           #   # #  #
#         #        # #
######################
