45 26
#############################################
#  ##     #    #       #     #         ##   #
#         #   #    ###   #      #        #  #
#    # #  #              #     ##           #
#     #   # ## ###        # #     #     #   #
#   #      #       #                  #     #
#         # ##     #  #2                    #
# #       #   ##  #     #    ##          # ##
#  #                #         #  #  # # #  ##
##   #  # #   ###  #   #  #  # #  ###   #   #
##    # ##            #             #  #    #
# ## #        #   #          #     #   #  # #
#     #            #             #    # #   #
#   # #    #             #            #     #
# #  #   #     #          #   #        # ## #
#    #  #             #            ## #    ##
#   #   ###  # #  #  #   #  ###   # #  #   ##
##  # # #  #  #         #                #  #
## #          ##    #     #  ##   #       # #
#                    1#  #     ## #         #
#     #                  #       #      #   #
#   #     #     # #        ### ## #   #     #
#           ##     #              #  # #    #
#  #        #      #   ###    #   #         #
#   ##         #     #       #    #     ##  #
#############################################
