16 17
################
##      #      #
#      #       #
#     #       ##
##             #
#              #
##   1      #  #
#     #        #
#              #
#        #     #
#  #      2   ##
#              #
#             ##
##       #     #
#       #      #
#      #      ##
################
