50 49
##################################################
#                  ##           #  #    ##  #   ##
#        #   #                             # #   #
# #       #     #  #     #       ##              #
#     #  # #    #          ##         #  #       #
#         #     #       #      ### ##  #   #     #
#  #             #  ## #      #                  #
####          #        #               #    #    #
#     #       #            #              #      #
# #           ##    # #   #                      #
# #           #     #         # #              # #
#       #                  # # #    # #          #
#            #  #    #        #                  #
# #        #    #           #         #      #   #
#     ## #          # #          2               #
#      #             # #          ## #    #      #
#      #                             #          ##
#  #   #  #                       #    #         #
#  #   ##                      #      #          #
#                      #  #       #              #
#                     #           # #            #
#           #             #   #        ##        #
#    #                            ##   # #  #    #
#                   #               #            #
#                #              #                #
#            #               #                   #
#    #  # #   ##                            #    #
#        ##        #   #             #           #
#            # #           #                     #
#              #       #  #                      #
#          #      #                      ##   #  #
#         #    #                       #  #   #  #
##          #                             #      #
#      #    # ##          # #             #      #
#               1          # #          # ##     #
#   #      #         #           #    #        # #
#                  #        #    #  #            #
#          # #    # # #                  #       #
# #              # #         #     #           # #
#                      #   # #    ##           # #
#      #              #            #       #     #
#    #    #               #        #          ####
#                  #      # ##  #             #  #
#     #   #  ## ###      #       #     #         #
#       #  #         ##          #    # #  #     #
#              ##       #     #  #     #       # #
#   # #                             #   #        #
##   #  ##    #  #           ##                  #
##################################################
