24 17
########################
#      #               #
#  ##              #   #
#                     ##
#  #  #     #          #
#   #    2 #    # #    #
#    # #       #     ###
#          ##      #   #
#      # ##  ## #      #
#   #      ##          #
###     #       # #    #
#    # #    # 1    #   #
#          #     #  #  #
##                     #
#   #              ##  #
#               #      #
########################
