17 20
#################
#  # #       #  #
#               #
# #             #
#               #
#      #   2#   #
#   #        ## #
#    #        # #
#       #       #
##     # #      #
#      # #     ##
#       #       #
# #        #    #
# ##        #   #
#   #1   #      #
#               #
#             # #
#               #
#  #       # #  #
#################
