21 18
#####################
# #   # #           #
##                 ##
#           #       #
#       #  1        #
#     #   #       # #
#                   #
#            #     ##
##                  #
#                  ##
##     #            #
#                   #
# #       #   #     #
#        2  #       #
#       #           #
##                 ##
#           # #   # #
#####################
