28 41
############################
#         #                #
###    ##          #       #
#      #   #         # #  ##
#    ###                   #
#    # # #     #           #
#          # ###     #     #
##    #       # #  # #   # #
#   #        # ##          #
##  # #        #  #      # #
#  #               #    #  #
##     #   #      ##  #    #
#    # #       # #    # #  #
#   #  #    #       ####   #
#           #  #     # #   #
##          #      #       #
# #         #     #        #
##  ### ##1   # #   ##  ## #
# ###    #  #     #   #    #
## #         #         #  ##
#   #     #      #     #   #
##  #         #         # ##
#    #   #     #  #    ### #
# ##  ##   # #   2## ###  ##
#        #     #         # #
#       #      #          ##
#   # #     #  #           #
#   ####       #    #  #   #
#  # #    # #       # #    #
#    #  ##      #   #     ##
#  #    #               #  #
# #      #  #        # #  ##
#          ## #        #   #
# #   # #  # #       #    ##
#     #     ### #          #
#           #     # # #    #
#                   ###    #
##  # #         #   #      #
#       #          ##    ###
#                #         #
############################
