20 23
####################
# #    # #    #    #
#      #    ##   # #
##   #     ##  ##  #
###   #   # #     ##
#      #  #  #  ####
# #  # # #  #   #  #
#      #    ## ##  #
##         #      ##
###      #    #  ###
# #  # #      1  # #
#   #    ##    #   #
# #  2      # #  # #
###  #    #      ###
##      #         ##
#  ## ##    #      #
#  #   #  # # #  # #
####  #  #  #      #
##     # #   #   ###
#  ##  ##     #   ##
# #   ##    #      #
#    #    # #    # #
####################
