20 17
####################
#        # #  #  # #
#    #  #   #  # # #
#   #   #    #     #
#            #     #
#           #     ##
#                  #
#  # #   ##2##     #
#     #      #     #
#     ##1##   # #  #
#                  #
##     #           #
#     #            #
#     #    #   #   #
# # #  #   #  #    #
# #  #  # #        #
####################
