21 34
#####################
#   #       # #     #
#   #   #     #     #
# # ##   #    # #  ##
#   #     # ###     #
#     #     ##   #  #
#     # #   #      ##
# # ##      #  #### #
# # #    #     # # ##
#  ## ##  #         #
#     # #    # #    #
# ####   # #      # #
#   #  #      #    ##
#  # #  #  #      2 #
#   #    # # #      #
####         ### # ##
##   #        #   # #
# #   #        #   ##
## # ###         ####
#      # # #    #   #
# 1      #  #  # #  #
##    #      #  #   #
# #      # #   #### #
#    # #    # #     #
#         #  ## ##  #
## # #     #    # # #
# ####  #      ## # #
##      #   # #     #
#  #   ##     #     #
#     ### #     #   #
##  # #    #   ## # #
#     #     #   #   #
#     # #       #   #
#####################
