19 16
###################
# # #             #
#    ## #         #
#  ##  #   #     ##
#      ##         #
#                 #
#      #          #
#               2 #
# 1               #
#          #      #
#                 #
#         ##      #
##     #   #  ##  #
#         # ##    #
#             # # #
###################
