28 15
############################
##      #  #   #   2   #   #
#             #  #         #
#      #   #    # #   #  # #
#  #    #    #           # #
#   #   #  #               #
# #    # #   #    #  # ##  #
# #                      # #
#  ## #  #    #   # #    # #
#               #  #   #   #
# #           #    #    #  #
# #  #   # #    #   #      #
#         #  #             #
#   #   1   #   #  #      ##
############################
