18 25
##################
#   #    ##  1 # #
# #  # # #       #
#         ###    #
#      #  #   # ##
#      #       ###
### # ##  ###  ###
#  #  ##       # #
#       ## ##    #
#            #  ##
# # #   ##       #
#              ###
#   # #    # #   #
###              #
#       ##   # # #
##  #            #
#    ## ##       #
# #       ##  #  #
###  ###  ## # ###
###       #      #
## #   #  #      #
#    ###         #
#       # # #  # #
# # 2  ##    #   #
##################
