20 23
####################
##   #  # #    # # #
#     #           ##
##        #   # ## #
#  #  # # #      # #
#    # #           #
#                 ##
#####  #         # #
#  # #  ###        #
#  #    #          #
#     # #  #2      #
#   # # #  # # #   #
#      1#  # #     #
#          #    #  #
#        ###  # #  #
# #         #  #####
##                 #
#           # #    #
# #      # # #  #  #
# ## #   #        ##
##           #     #
# # #    # #  #   ##
####################
