42 41
##########################################
#      #     #              ##        #  #
#        #  #            #               #
#      #                                 #
#                 ##         #    #   #  #
#                  #                     #
#          #                             #
#               #                        #
#                         #              #
# #                           ##     #   #
#             #                          #
#        #      #   #               #    #
#       #          #   #                 #
#            #         #              # ##
# #            #1 ###            #       #
#                  #   #        # #    # #
# #   #                    #      #      #
#  #             #  #                    #
#          #                    #        #
#              #     #                  ##
#            #              #            #
##                  #     #              #
#        #                    #          #
#                    #  #             #  #
#      #      #                    #   # #
# #    # #        #   #                  #
#       #            ### 2#            # #
## #              #         #            #
#                 #   #          #       #
#    #               #   #      #        #
#                          #             #
#   #     ##                           # #
#              #                         #
#                        #               #
#                             #          #
#                     #                  #
#  #   #    #         ##                 #
#                                 #      #
#               #            #  #        #
#  #        ##              #     #      #
##########################################
