46 41
##############################################
# #     #             #           #   #      #
#                                            #
#                                  ###   ##  #
#   ## #                             ##    # #
#      #                     #       # #     #
#              #             #               #
#      #       #               #             #
#    #     #                  ##          #  #
## #   # #         ##    #      #            #
#  #                      #                  #
#         # #     #                       #  #
#  ###       #     #                    ##   #
#     #         #         # #       1  #     #
#                              #      #      #
#        ##            ##                  # #
#                           #                #
#          #   #       #         #           #
##   #   #                          #        #
#       #  #                             #   #
#     ##   ##        #  #        ##   ##     #
#   #                             #  #       #
#        #                          #   #   ##
#           #         #       #   #          #
#                #                           #
# #                  ##            ##        #
#      #      #                              #
#     #  2       # #         #         #     #
#   ##                    #     #       ###  #
#  #                       #     # #         #
#                  #                      #  #
#            #      #    ##         # #   # ##
#  #          ##                  #     #    #
#             #               #       #      #
#               #             #              #
#     # #       #                     #      #
# #    ##                             # ##   #
#  ##   ###                                  #
#                                            #
#      #   #           #             #     # #
##############################################
