17 16
#################
#  ## #  #  # # #
#   ## #    #   #
# ###      #    #
## #            #
## 2   #     #  #
# ## #       # ##
#   ##  # #  # ##
## #  # #  ##   #
## #       # ## #
#  #     #   1 ##
#            # ##
#    #      ### #
#   #    # ##   #
# # #  #  # ##  #
#################
