31 46
###############################
##                            #
#                            ##
#  #                          #
#       #               #  #  #
#   #      #         #  # #   #
#               #            ##
#                         #   #
# #    # #                   ##
#                  #    #     #
#         #         #         #
#         #      #     # #    #
#      2    #                 #
#                 #           #
#                    #        #
#                             #
#  #    #      #           #  #
#   #          #        #    ##
#        #   # # #    #    #  #
#        #                    #
#                             #
#           ##                #
#                #       #    #
#    #       #                #
#                ##           #
#                             #
#                    #        #
#  #    #    # # #   #        #
##    #        #          #   #
#  #           #      #    #  #
#                             #
#        #                    #
#           #                 #
#                 #    1      #
#    # #     #      #         #
#         #         #         #
#     #    #                  #
##                   # #    # #
#   #                         #
##            #               #
#   # #  #         #      #   #
#  #  #               #       #
#                          #  #
##                            #
#                            ##
###############################
