45 22
#############################################
##         #                         # #    #
#    #   #                 #                #
#  ##  #    #    2          #              ##
#        #                          #       #
##                                        ###
#       #    #        #          #          #
#            # #      #                   # #
#                                           #
#                          #             #  #
#        #  #               #              ##
##              #               #  #        #
#  #             #                          #
#                                           #
# #                   #      # #            #
#          #          #        #    #       #
###                                        ##
#       #                          #        #
##              #          1    #    #  ##  #
#                #                 #   #    #
#    # #                         #         ##
#############################################
