28 17
############################
#          #      #  #     #
#  # #   #              #  #
#    #                     #
#              #           #
#      #             # ##  #
#        #  #           #  #
# #   #  #      2          #
#  #    #   #  #   #    #  #
#          1      #  #   # #
#  #           #  #        #
#  ## #             #      #
#           #              #
#                     #    #
#  #              #   # #  #
#     #  #      #          #
############################
