18 15
##################
#        #       #
##     #  #      #
#         #      #
#         ## #  ##
#      #      #  #
#  1  #  #       #
# #  ## ## ##  # #
#       #  #  2  #
#  #      #      #
##  # ##         #
#      #         #
#      #  #     ##
#       #        #
##################
