15 28
###############
##   #      # #
## #    #     #
# #  #   #    #
# #  # #    # #
#       #2    #
##  #   #     #
#        #   ##
##    #    #  #
# #   # #  #  #
#   #   # #   #
##      # ### #
#          # ##
##     #   #  #
#  #   #     ##
## #          #
# ### #      ##
#   # #   #   #
#  #  # #   # #
#  #    #    ##
##   #        #
#     #   #  ##
#    1#       #
# #    # #  # #
#    #   #  # #
#     #    # ##
# #      #   ##
###############
