17 34
#################
##           # ##
#           # # #
#    #       #  #
#  #       # ## #
#   #    #      #
#   #     #  #  #
#        #      #
#     ##  #     #
#       #       #
#      #       ##
#  #           ##
####    ## #    #
#  # 1 #        #
#               #
#   #   #   #  ##
#   #           #
#           #   #
##  #   #   #   #
#               #
#        # 2 #  #
#    # ##    ####
##           #  #
##       #      #
#       #       #
#     #  ##     #
#      #        #
#  #  #     #   #
#      #    #   #
# ## #       #  #
#  #       #    #
# # #           #
## #           ##
#################
