19 16
###################
# #  #         #  #
#   ###     #     #
#    #     #     ##
#    ##    #      #
# #    #   ##   # #
#1                #
#   #         ##  #
#  ##         #   #
#                2#
# #   ##   #    # #
#      #    ##    #
##     #     #    #
#     #     ###   #
#  #         #  # #
###################
