30 49
##############################
# ##    #         ###  #    ##
#    #  ## #  # ##       #   #
#  #   #                  #  #
#  #          #     #    ### #
###  ## ## #            #    #
#         # # #   ###     ## #
##        #    #  #      #  ##
#       #     #     #        #
## #    #   # #  ##          #
# #          #  #  #     #   #
####     # #   #          ## #
#  #   #             #       #
#         ##      # # # ##   #
#  #   #  # #         #      #
##              #         ## #
#  ##    ##       #          #
#   #    #    #    #        2#
#      #          #   ###    #
#         ##   #    # #  #   #
# #  #  #            ####    #
# ## # ##       #    #       #
#            ###      #   ## #
#   ##   #   #       #  # #  #
#           # ## #           #
#  # #  #       #   #   ##   #
# ##   #      ###            #
#       #    #       ## # ## #
#    ####            #  #  # #
#   #  # #    #   ##         #
#    ###   #          #      #
#1        #    #    #    #   #
#          #       ##    ##  #
# ##         #              ##
#      #         # #  #   #  #
#   ## # # #      ##         #
#       #             #   #  #
# ##          #   # #     ####
#   #     #  #  #          # #
#          ##  # #   #    # ##
#        #     #     #       #
##  #      #  #    #        ##
# ##     ###   # # #         #
#    #            # ## ##  ###
# ###    #     #          #  #
#  #                  #   #  #
#   #       ## #  # ##  #    #
##    #  ###         #    ## #
##############################
