18 31
##################
#         #  2   #
# #   #  #   # # #
# #     #   #    #
#  #        #    #
# #  ##       #  #
# #  #      # #  #
#  #       #  #  #
#  # #    #  #   #
## ##     ##   # #
#  #    ##      ##
# ##      # #  # #
##  ##  ## # #   #
#  # #        # ##
##     #   #   # #
#  #  ######  #  #
# #   #   #     ##
## #        # #  #
#   # # ##  ##  ##
# #  # #      ## #
##      ##    #  #
# #   ##     ## ##
#   #  #    # #  #
#  #  #       #  #
#  # #      #  # #
#  #       ##  # #
#    #        #  #
#    #   #     # #
# # #   #  #   # #
#   1  #         #
##################
