44 15
############################################
#   ###   #  #  #   # ##    ###   ##     # #
#   ##                #       #        ##  #
#   # #       # ## #       #  ###          #
#     ####  1       #        #      ##    ##
## ##  #   ##  # #            ##      ######
# # #      #    #    #      #        #     #
# #    #   #  ##  #      #  ##  #   #    # #
#     #        #      #    #    #      # # #
######      ##            # #  ##   #  ## ##
##    ##      #        #       2  ####     #
#          ###  #       # ## #       # #   #
#  ##        #       #                ##   #
# #     ##   ###    ## #   #  #  #   ###   #
############################################
