19 22
###################
#  #           #  #
##       #      # #
##  #  #     #    #
#   2          #  #
##                #
# #           #  ##
# ###  #      #  ##
##  #       #     #
#                 #
#      #          #
#          #      #
#                 #
#     #       #  ##
##  #      #  ### #
##  #           # #
#                ##
#  #          1   #
#    #     #  #  ##
# #      #       ##
#  #           #  #
###################
