47 22
###############################################
#               #       #                   # #
#      #                 #         #   #   #  #
#             #  #           #  #             #
#              1              #       ##      #
#         # #                       #         #
#                  #      #          #        #
#    #                  #         #          ##
# #   #            #                         ##
#      # #                                    #
#  #    #                        #            #
#            #                        #    #  #
#                                    # #      #
##                         #            #   # #
##          #         #                  #    #
#        #          #      #                  #
#         #                       # #         #
#      ##       #              2              #
#             #  #           #  #             #
#  #   #   #         #                 #      #
# #                   #       #               #
###############################################
