23 22
#######################
## ###  #         #   #
#    ###      ##      #
#   #       #         #
##       # #  ##   #  #
#     #      #        #
#        #   #     #  #
# 2   ###   #    #   ##
##   # ###           ##
#       #     #   #   #
#   #           #   ###
###   #           #   #
#   #   #     #       #
##           ### #   ##
##   #    #   ###   1 #
#  #     #   #        #
#        #      #     #
#  #   ##  # #       ##
#         #       #   #
#      ##      ###    #
#   #         #  ### ##
#######################
