16 29
################
#     #        #
#             ##
#         #    #
# #          ###
##  #        # #
#  ##          #
#            # #
#   #1# # #    #
#        # #  ##
# #    # #     #
#             ##
#   # #  #    ##
#              #
#              #
#              #
##    #  # #   #
##             #
#     # #    # #
##  # #        #
#    # # #2#   #
# #            #
#          ##  #
# #        #  ##
###          # #
#    #         #
##             #
#        #     #
################
