17 34
#################
#      #        #
#         #  #  #
#    # #        #
#               #
## #   #      # #
#            #  #
#  #   #        #
#   #      #    #
#               #
#     #         #
# #       #     #
#      #        #
##   ##  #      #
#      ##       #
#  #          ###
#  2      #     #
#     #      1  #
###          #  #
#       ##      #
#      #  ##   ##
#        #      #
#     #       # #
#         #     #
#               #
#    #      #   #
#        #   #  #
#  #            #
# #      #   # ##
#               #
#        # #    #
#  #  #         #
#        #      #
#################
