16 23
################
#   1          #
#     ##       #
# #            #
#    #    #    #
#           #  #
#              #
#           #  #
#              #
#             ##
#     ##      ##
#  #        #  #
##      ##     #
##             #
#              #
#  #           #
#              #
#  #           #
#    #    #    #
#            # #
#       ##     #
#          2   #
################
