15 26
###############
# #         # #
# #    # # ####
# ###   ##1# ##
#       ##    #
#             #
#  ## #       #
##     ##     #
#   ## ## #   #
##     #   #  #
# ## #   # ## #
## #  # # #   #
#  #       #  #
#  #       #  #
#   # # #  # ##
# ## #   # ## #
#  #   #     ##
#   # ## ##   #
#     ##     ##
#       # ##  #
#             #
#    ##       #
## #2##   ### #
#### # #    # #
# #         # #
###############
