22 49
######################
#     #  #    #  #   #
# #       # #  #  #  #
#  #   2    #   #    #
###     #          ###
#  ###    # #    ##  #
# ##      # #   ###  #
#       ##   #       #
#   #   #   #  #     #
## #                ##
#    #  ### #       ##
#    #   #           #
##    #  #     #     #
#                   ##
#  #    # # # ##     #
#       #            #
#    #    #          #
##              #    #
#    #   #    #   # ##
# #   ##  ##   #    ##
#        #  #        #
#       #       # ## #
#  # #    #        ###
##### # #  #   #   # #
#                    #
# #   #   #  # # #####
###        #    # #  #
# ## #       #       #
#        #  #        #
##    #   ##  ##   # #
## #   #    #   #    #
#    #              ##
#          #    #    #
#            #       #
#     ## # # #    #  #
##                   #
#     #     #  #    ##
#           #   #    #
##       # ###  #    #
##                # ##
#     #  #   #   #   #
#       #   ##       #
#  ###   # #      ## #
#  ##    # #    ###  #
###          #     ###
#    #   #    1   #  #
#  #  #  # #       # #
#   #  #    #  #     #
######################
