32 29
################################
#    #   #        #   # #      #
##         ###         #      ##
##       #    #    #  #        #
##                #  #       2 #
##      ##     ###  ##   ##   ##
#  #   #     #  # ##     #    ##
#         #  #       #   #   # #
#  ##     # ##  # #     # #   ##
##  #  #       ## #    #       #
#  #         # ###      #    # #
#           ###      #  # # ## #
#          #   #     #   # # # #
#         #             #     ##
#                              #
##     #             #         #
# # # #   #     #   #          #
# ## # #  #      ###           #
# #    #      ### #         #  #
#       #    # ##       #  #  ##
##   # #     # #  ## #     ##  #
# #   #   #       #  #         #
##    #     ## #  #     #   #  #
##   ##   ##  ###     ##      ##
# 1       #  #                ##
#        #  #    #    #       ##
##      #         ###         ##
#      # #   #        #   #    #
################################
