35 20
###################################
#               #      #        # #
#        #                 #      #
#      # #                        #
#          2  #         #         #
#           #     #         #     #
#          #            #         #
#           #    #   #            #
#                         #       #
#            # #          #       #
#       #          # #            #
#       #                         #
#            #   #    #           #
#         #            #          #
#     #         #     #           #
#         #         #  1          #
#                        # #      #
#      #                 #        #
# #        #      #               #
###################################
