32 17
################################
#         #                    #
# #   #    #        #          #
#                              #
##    #      #                 #
##     #       #    #    #     #
#        ##      #  ##  #   1# #
#                    #        ##
#      #                #      #
##        #                    #
# #2   #  ##  #      ##        #
#     #    #    #       #     ##
#                 #      #    ##
#                              #
#          #        #    #   # #
#                    #         #
################################
