22 37
######################
#            #       #
#       #  #  #      #
#          #    # #  #
#   #  #             #
#       #         #  #
#     #  #           #
#    #   #           #
# ##              #  #
#           # #      #
#                  # #
#   #   #            #
#                    #
#                # # #
#                    #
# #                  #
#                    #
# #2                 #
#                    #
#                 1# #
#                    #
#                  # #
#                    #
# # #                #
#                    #
#            #   #   #
# #                  #
#      # #           #
#  #              ## #
#           #   #    #
#           #  #     #
#  #         #       #
#             #  #   #
#  # #    #          #
#      #  #  #       #
#       #            #
######################
