23 28
#######################
# #  ##            ## #
# #       ##  # ###   #
#   # # ##     ##    ##
#    # #  #           #
#    #  #   # #       #
#      #  #       # # #
# ## ## #        #   ##
# #  #    ### # ##  # #
##  1## #       #    ##
##           #    ##  #
#            #     #  #
#     #     # #     # #
## #  # ##   # #    ###
###    # #   ## #  # ##
# #     # #     #     #
#  #     #            #
#  ##    #           ##
##    #       # ##2  ##
# #  ## # ###    #  # #
##   #        # ## ## #
# # #       #  #      #
#       # #   #  #    #
#           #  # #    #
##    ##     ## # #   #
#   ### #  ##       # #
# ##            ##  # #
#######################
