44 43
############################################
#   #         #                  #         #
#      #       ##      # ##           #  # #
# #                #                       #
# ##     #                                ##
#  #     #  # #                 ## #       #
#             #  #         #              ##
#      #         ##     #                  #
#    #        #      1  #    # #          ##
#                                   #      #
#        #   #   #      #    #             #
#        #                 #            #  #
#  #   #             #                     #
## #   # #            #     ##           # #
#         #         # #  # #             # #
#      #   #    # #                   #    #
#       #   ##  # ##         #             #
#      #                 #              #  #
#                   ##     #     #  #    # #
# #                #  #         #     # ## #
#  #       #            #             #### #
# ### ##   #       #    #       #   ## ### #
# ####             #            #       #  #
# ## #     #         #  #                # #
# #    #  #     #     ##                   #
#  #              #                 #      #
#             #         ## #  ##   #       #
#    #                   # #    #   #      #
# #             # #  # #         #         #
# #           ##     #            # #   # ##
#                     #             #   #  #
#  #            #                 #        #
#             #    #      #   #   #        #
#      #                                   #
##          # #    #  2      #        #    #
#                  #     ##         #      #
##              #         #  #             #
#       # ##                 # #  #     #  #
##                                #     ## #
#                       #                # #
# #  #           ## #      ##       #      #
#         #                  #         #   #
############################################
