33 34
#################################
#           #                   #
###         # #                 #
#          #                    #
#     #   #       #             #
# ##    #   #   #   #           #
#                               #
#           # #           #     #
#       # 1#                #   #
#              #        #    #  #
#               #        #  #   #
# #       #     #           #   #
#   #      #      #         ##  #
#                #         #    #
#            #         #      ###
#          #       #  #       # #
#              ###              #
#              ###              #
# #       #  #       #          #
###      #         #            #
#    #         #                #
#  ##         #      #      #   #
#   #           #     #       # #
#   #  #        #               #
#  #    #        #              #
#   #                #2 #       #
#     #           # #           #
#                               #
#           #   #   #   #    ## #
#             #       #   #     #
#                    #          #
#                 # #         ###
#                   #           #
#################################
