49 18
#################################################
#         #           #     #        # #        #
#                    #    # 1        ## #       #
#               #               #  #          # #
##  # #    #  #         #                       #
# # #                                           #
#                    #                          #
#       #     #                          #      #
#     #  #  #  #              #                 #
#                 #              #  #  #  #     #
#      #                          #     #       #
#                          #                    #
#                                           # # #
#                       #         #  #    # #  ##
# #          #  #               #               #
#       # ##        2 #    #                    #
#        # #        #     #           #         #
#################################################
