17 26
#################
#    #    ##    #
#               #
#               #
#               #
#               #
#        #      #
##  #          ##
#      #        #
#  #   #     #  #
#       # #     #
#     2         #
#  ##    #      #
#      #    ##  #
#         1     #
#     # #       #
#  #     #   #  #
#        #      #
##          #  ##
#      #        #
#               #
#               #
#               #
#               #
#    ##    #    #
#################
