36 25
####################################
#     #                         #  #
#    #    #                        #
#    ##            #    #          #
#            #  2                  #
#       #       #    #             #
#                 #                #
##       #                   #     #
#    #     #                       #
#    #                      #     ##
#           #        ##  #   #     #
#                      # #       # #
#        #                #        #
# #       # #                      #
#     #   #  ##        #           #
##     #                      #    #
#                       #     #    #
#     #                   #       ##
#                #                 #
#             #    #       #       #
#                  1  #            #
#          #    #            ##    #
#                        #    #    #
#  #                         #     #
####################################
