24 21
########################
##   ## ##   ## #  #  ##
##  #      ##      # ###
#    #         #  ##   #
#      #  #     #  #   #
#   ##   #  #          #
# #   #    #        # ##
# #   #   # #  #   ##  #
#          # # #   # # #
#  #         #     #   #
# #   #2  #  #  1#   # #
#   #     #         #  #
# # #   # # #          #
#  ##   #  # #   #   # #
## #        #    #   # #
#          #  #   ##   #
#   #  #     #  #      #
#   ##  #         #    #
### #      ##      #  ##
##  #  # ##   ## ##   ##
########################
