24 41
########################
#    #  #              #
# #  #            #    #
#               #      #
#             #  #     #
#           #     #    #
#                   #  #
#         #            #
# #    #       #       #
#                  #   #
#                      #
#         #  ##        #
#   1    #          # ##
#   #  #   #    #      #
#     #  #             #
#            #  #     ##
##         # ##        #
#       #         #    #
#                  #   #
#   #        # #      ##
#                      #
##      # #        #   #
#   #                  #
#    #         #       #
#        ## #         ##
##     #  #            #
#             #  #     #
#      #    #   #  #   #
## #          #    2   #
#        ##  #         #
#                      #
#   #                  #
#       #       #    # #
#            #         #
#  #                   #
#    #     #           #
#     #  #             #
#      #               #
#    #            #  # #
#              #  #    #
########################
