45 34
#############################################
#        # # #                #             #
#           # 2    #       #          #     #
#                                           #
#                 #    #              ##    #
#         #     ##              #           #
#    #             #          #        #    #
#                                 #   #     #
#          #                #               #
#                                          ##
#              #         #                  #
##             #       #   # #    #   #     #
## ##                 #                   # #
#               #                #          #
##   #                 #        # #         #
#                       #                   #
# #                        #              # #
# #              #                        # #
#                   #                       #
#         # #        #                 #   ##
#          #                #               #
# #                   #                 ## ##
#     #   #    # #   #       #             ##
#                  #         #              #
##                                          #
#               #                #          #
#     #   #                                 #
#    #        #          #             #    #
#           #              ##     #         #
#    ##              #    #                 #
#                                           #
#     #          #       #    1 #           #
#             #                # # #        #
#############################################
