37 22
#####################################
#     #             #      #    #   #
##            #                 #   #
#                #           #      #
#                   #            #  #
#                #  ##           #  #
#         #                  # #    #
#   #                       ##      #
#        #                          #
##  2  #        #              #   ##
#             #                     #
#                     #             #
##   #              #        #  1  ##
#                          #        #
#      ##                       #   #
#    # #                  #         #
#  #           ##  #                #
#  #            #                   #
#      #           #                #
#   #                 #            ##
#   #    #      #             #     #
#####################################
