18 15
##################
#                #
#    #  #   #    #
# #    #         #
## ##    #      ##
##   #  2        #
### #   #    # # #
# #            # #
# # #    #   # ###
#        1  #   ##
##      #    ## ##
#         #    # #
#    #   #  #    #
#                #
##################
