15 36
###############
# #   #   #   #
#        #   ##
#             #
#           # #
#             #
#  #    #     #
#        #    #
#          2  #
#             #
#    #       ##
#        #    #
#             #
# # #         #
#  #          #
#  # #        #
#             #
#     #       #
#       #     #
#             #
#        # #  #
#          #  #
#         # # #
#             #
#    #        #
##       #    #
#             #
#  1          #
#    #        #
#     #    #  #
#             #
# #           #
#             #
##   #        #
#   #   #   # #
###############
