40 35
########################################
#    #  #  #                           #
# #                 ##       #     #   #
#   #        #  #                   #  #
#      #    #                          #
#               #      #               #
#               #  #                  ##
#           ##                   ##    #
#                                      #
#             # #              #       #
#   ##                     2  #        #
#             #        #     ##        #
#                  # #       #  #    # #
#                               #      #
#                    #                 #
#    #            #                    #
# #      #         #                   #
#        #                    #        #
#                   #         #      # #
#                    #            #    #
#                 #                    #
#      #                               #
# #    #  #       # #                  #
#        ##     #        #             #
#        #  1                     ##   #
#       #              # #             #
#                                      #
#    ##                   ##           #
##                  #  #               #
#               #      #               #
#                          #    #      #
#  #                   #  #        #   #
#   #     #       ##                 # #
#                           #  #  #    #
########################################
