44 49
############################################
#                              #           #
#        #  #      #   # #                 #
##       #     #       #   #  #           ##
#                 #                 #      #
#                                  #       #
#       #                                  #
#                   #                      #
#                                 #        #
#    #     #                            #  #
#        #         #                       #
#      #       #   #    #            #    ##
##                                   #     #
#                                     #  # #
#1    #    #                    #   #   #  #
#            #               #  #    # #   #
# #                                        #
#    #      #          #         #         #
#             ##          #              # #
##                               ##        #
#   #  #       ##                  #       #
#             #          #           #     #
##           #                    #     #  #
#         #            #    #  #     #     #
#       #          ##  ##          #       #
#     #     #  #    #            #         #
#  #     #                    #           ##
#     #           #          #             #
#       #                  ##       #  #   #
#        ##                               ##
# #              #          ##             #
#         #         #          #      #    #
#                                        # #
#   # #    #  #               #            #
#  #   #   #                    #    #    2#
# #  #                                     #
#     #                                   ##
##    #            #    #   #       #      #
#                       #         #        #
#  #                            #     #    #
#        #                                 #
#                      #                   #
#                                  #       #
#       #                                  #
#      #                 #                 #
##           #  #   #       #     #       ##
#                 # #   #      #  #        #
#           #                              #
############################################
