15 26
###############
#        #  # #
#    #  ##    #
#    #        #
#             #
#         #   #
#             #
#       #     #
#       #2 #  #
#             #
#             #
#  #    #     #
##          # #
# #          ##
#     #    #  #
#             #
#             #
#  # 1#       #
#     #       #
#             #
#   #         #
#             #
#        #    #
#    ##  #    #
# #  #        #
###############
