18 17
##################
#      2      #  #
#  #      #     ##
# #       #   #  #
# #       #    # #
##               #
# #         #    #
#                #
#                #
#                #
#    #         # #
#               ##
# #    #       # #
#  #   #       # #
##     #      #  #
#  #      1      #
##################
