17 28
#################
#               #
#    #  2       #
#     #         #
#               #
#     #         #
#               #
#       #  #    #
#     # ##  #   #
#           #   #
#       #      ##
#        #  #   #
#     #    # #  #
#            #  #
#  #            #
#  # #    #     #
#   #  #        #
##      #       #
#   #           #
#   #  ## #     #
#    #  #       #
#               #
#         #     #
#               #
#         #     #
#       1  #    #
#               #
#################
