15 16
###############
##  #     #   #
# #  #        #
# #           #
# #         # #
#             #
#       1     #
#        #    #
#    #        #
#     2       #
#             #
# #         # #
#           # #
#        #  # #
#   #     #  ##
###############
