25 16
#########################
#      #     # #      # #
#1    # #       #    ## #
#     ##        #       #
# #   # #     #  #      #
#           #  ##       #
#                       #
#         #    #        #
#        #    #         #
#                       #
#       ##  #           #
#      #  #     # #   # #
#       #        ##     #
# ##    #       # #    2#
# #      # #     #      #
#########################
