30 15
##############################
#                       # #  #
#          #    #  #       # #
#        ##     #    #  #    #
#              #    #        #
###             #         # ##
##       2              #    #
## #                      # ##
#    #              1       ##
## #         #             ###
#        #    #              #
#    #  #    #     ##        #
# #       #  #    #          #
#  # #                       #
##############################
