32 15
################################
#                  #  #        #
#             #          #     #
#      #   #  ##    #          #
#        #   #                 #
#           # ##               #
#    #    #               1    #
#                              #
#    2               #    #    #
#               ## #           #
#                 #   #        #
#          #    ##  #   #      #
#     #          #             #
#        #  #                  #
################################
