50 49
##################################################
##      ##     # #           #           #       #
#                 #     #            #     #     #
#           #         #                          #
#    #    #      #                  # #         ##
#                         #         #          # #
#   #                # #  #       #      # #     #
#  #  # #    ## #             #        #         #
#    #        #           #               #    # #
#                  ##            #     #         #
#    #            #                 #      #     #
# #                #           #    #       #    #
#          # #              #             #     ##
#       #   #  #         ##   #  #  #     ##     #
# #     #   #     #   #        #     #1 ##       #
#   #                         ##                 #
#        #              #     #    ##            #
#            ##    #       #    #                #
#     #                         #    #           #
#          #     #                               #
###  #                     #                     #
# #    #     #    #          #  #      #  #     ##
##               # # #                   #       #
#         #                   #               # ##
#                                                #
## #               #                   #         #
#       #                   # # #               ##
##     #  #      #  #          #    #     #    # #
#                     #                     #  ###
#                               #     #          #
#           #    #                         #     #
#                #    #       #    ##            #
#            ##    #     #              #        #
#                 ##                         #   #
#       ## 2#     #        #   #     #   #     # #
#     ##     #  #  #   ##         #  #   #       #
##     #             #              # #          #
#    #       #    #           #                # #
#     #      #                 #            #    #
#         #     #            ##                  #
# #    #               #           #        #    #
#         #        #             # ##    # #  #  #
#     # #      #       #  # #                #   #
# #          #         #                         #
##         # #                  #      #    #    #
#                          #         #           #
#     #     #            #     #                 #
#       #           #           # #     ##      ##
##################################################
