38 43
######################################
#            #           #           #
#       ##                           #
#                   #     #     #    #
##         #                # #      #
##             #          #          #
#                                  ###
#        #        ####               #
#           #     ##            # #  #
#       #             #              #
#                                    #
#           # #     ###              #
#       #                  #         #
#                   #             #  #
#                                    #
#                                #   #
#         #   #       ###     #      #
#                     1 ##  #        #
##                   #     #   # #   #
#       #             ##             #
#    #   #        #    #      ##     #
#  ##             ##             ##  #
#     ##      #    #        #   #    #
#             ##             #       #
#   # #   #     #                   ##
#        #  ## 2                     #
#      #     ###       #   #         #
#   #                                #
#                                    #
#  #             #                   #
#         #                  #       #
#              ###     # #           #
#                                    #
#              #             #       #
#  # #            ##     #           #
#               ####        #        #
###                                  #
#          #          #             ##
#      # #                #         ##
#    #     #     #                   #
#                           ##       #
#           #           #            #
######################################
