21 16
#####################
# #     #  # #      #
#  #                #
#    #  1  #       ##
##     # #          #
#                  ##
#         #     #   #
#     #     #   # ###
### #   #     #     #
#   #     #         #
##                  #
#          # #     ##
##       #  2  #    #
#                #  #
#      # #  #     # #
#####################
