18 23
##################
#  #      ##  #  #
#     #      #   #
#        #    ## #
#     1   #  #   #
# #   #          #
#   #            #
# #              #
#           #   ##
#  #     ###   # #
###  #       #   #
#  ##        ##  #
#   #       #  ###
# #   ###     #  #
##   #           #
#              # #
#            #   #
#          #   # #
#   #  #   2     #
# ##    #        #
#   #      #     #
#  #  ##      #  #
##################
