16 17
################
## #  #      ###
#2         # # #
#              #
#              #
#              #
# #      ##  # #
##             #
#              #
#             ##
# #  ##      # #
#              #
#              #
#              #
# # #         1#
###      #  # ##
################
