47 30
###############################################
# #    #    #               #                 #
#     #   # #  ##               #             #
#    ## #                        #         #  #
#              ##              #     #        #
#          #     ###     #             #   #  #
#                     #    #                 ##
#          #             #    #        #    # #
#     #               #                1#   # #
##        ## #                    #           #
#       #           # #                    # ##
#                         #      #            #
#                               #         #   #
#    #               #   #                #   #
#                                #           ##
##           #                                #
#   #                #   #               #    #
#   #         #                               #
#            #      #                         #
## #                    # #           #       #
#           #                    # ##        ##
# #   #2                #               #     #
# #    #        #    #             #          #
##                 #    #                     #
#  #   #             #     ###     #          #
#        #     #              ##              #
#  #         #                        # ##    #
#             #               ##  # #   #     #
#                 #               #    #    # #
###############################################
