32 35
################################
#       #  #               #   #
# #            #  #         #  #
#  #                #   #1     #
#                 ## #         #
# #   #                #       #
#   ##   #  #          #       #
#        #           ##  #  #  #
#                        #    ##
#   ##          #       ###  # #
###                            #
#                           ## #
#    ##         #              #
#            #            #    #
## ##     # #   #              #
##   ##     # #           ##   #
#  #        # #      #         #
#    ###                ###    #
#         #      # #        #  #
#   ##           # #     ##   ##
#              #   # #     ## ##
#    #            #            #
#              #         ##    #
# ##                           #
#                            ###
# #  ###       #          ##   #
##    #                        #
#  #  #  ##           #        #
#       #          #  #   ##   #
#       #                #   # #
#         # ##                 #
#     2#   #                #  #
#  #         #  #            # #
#   #               #  #       #
################################
