36 21
####################################
#                         #    #   #
##   #  #    #        # #  #       #
#      #    #          #         2 #
#                          #     ###
#                  ##   # #        #
#          #   #    #          #   #
#  #      #                    #   #
# #  #  #  # #     #    #         ##
# #   #      #               ##    #
#     ##                    ##     #
#    ##               #      #   # #
##         #    #     # #  #  #  # #
#   #                    #      #  #
#   #          #    #   #          #
#        # #   ##                  #
###     #                          #
# 1         #          #    #      #
#       #  # #        #    #  #   ##
#   #    #                         #
####################################
