29 24
#############################
#          #      #     # ###
###  #   #       #   #      #
#         # # ###     ## #  #
# # ## #   #         # ##   #
#      #   #   #        #   #
##   # #    #               #
# #       #       #         #
#            #  #     #     #
#      # #    #             #
#                           #
#    #       # ##   2       #
#       1   ## #       #    #
#                           #
#             #    # #      #
#     #     #  #            #
#         #       #       # #
#               #    # #   ##
#   #        #   #   #      #
#   ## #         #   # ## # #
#  # ##     ### # #         #
#      #   #       #   #  ###
### #     #      #          #
#############################
