17 24
#################
# #          # ##
#    #  #      ##
### 1    #   #  #
#   ##          #
##  # #       # #
##   #   #    # #
#    #     #  ###
##     ###      #
#  #            #
#    #   ### #  #
#  #        #   #
#   #        #  #
#  # ###   #    #
#            #  #
#      ###     ##
###  #     #    #
# #    #   #   ##
# #       # #  ##
#          ##   #
#  #   #    2 ###
##      #  #    #
## #          # #
#################
