46 49
##############################################
#   #           #                            #
#                  #  #                      #
# #                      #         #  #    # #
#                 #        #                 #
#   #       # #      #     #     #    #      #
#     #        #      #  ##                  #
#          ##   #      #    #                #
#     #    #         #   #     #     #       #
#      #          #  # #             #       #
# #      #                                   #
#  #      #              #          ##    #  #
#                                 #          #
# #                                   #   #  #
#                                      # #   #
#               #       #       # #   #      #
#                    #  #    #    #       #  #
##   ##    #        #                       ##
#          # #    #   #                      #
#      #  ##                      #          #
#    2      #                               ##
#                   #                        #
#           ##                            #  #
#             #     #   #               #    #
#                  #      #                  #
#    #               #   #     #             #
#  #                            ##           #
#                        #                   #
##                               #      1    #
#          #                      ##  #      #
#                      #   #    # #          #
##                       #        #    ##   ##
#  #       #    #    #  #                    #
#      #   # #       #       #               #
#   # #                                      #
#  #   #                                   # #
#          #                                 #
#  #    ##          #              #      #  #
#                                   #      # #
#       #             # #  #          #      #
#       #     #     #   #         #    #     #
#                #    #      #   ##          #
#                  ##  #      #        #     #
#      #    #     #     #      # #       #   #
#                 #        #                 #
# #    #  #         #                      # #
#                      #  #                  #
#                            #           #   #
##############################################
