29 16
#############################
#      #           #        #
#  #   #       #            #
#        #                  #
# #                 #     # #
#    #                      #
#         # #         #2    #
#        #                  #
#                  #        #
#    1#         # #         #
#                      #    #
# #     #                 # #
#                  #        #
#            #       #   #  #
#        #           #      #
#############################
