49 22
#################################################
##    # #    #        #      #          #       #
#          #                 ##     1     #     #
#           ##    #      #           #   ###    #
# ##               #   #      #         #       #
#    #  #             #                   #     #
#       #    #        #          #  # #    # #  #
#    #      #   #         ##   ##    # # #   #  #
##                   #   #                      #
#                    # #                  #     #
#        #  ##  #        #      #   ##        # #
# #        ##   #      #        #  ##  #        #
#     #                  # #                    #
#                      #   #                   ##
#  #   # # #    ##   ##         #   #      #    #
#  # #    # #  #          #        #    #       #
#     #                   #             #  #    #
#       #         #      #   #               ## #
#    ###   #           #      #    ##           #
#     #     2     ##                 #          #
#       #          #      #        #    # #    ##
#################################################
