17 22
#################
#   #    #    # #
#           #   #
#               #
#               #
##             ##
# #      #  # # #
#  #     #      #
#      #        #
#          2    #
#               #
#               #
#    1          #
#        #      #
#      #     #  #
# # #  #      # #
##             ##
#               #
#               #
#   #           #
# #    #    #   #
#################
