45 16
#############################################
# ##     ####  # # ##    #      ##   #      #
#   #    ##  # #   #  #   #       #     #   #
#   # # #  #  ##  #          ##           # #
#  #  #               #    ###   #       2  #
#             #    #  #   # #  #         #  #
#      # ##  ##  #  #    ## ##   #     # #  #
#####   # ##  #  #  ##         ##    #  #   #
#   #  #    ##         ##  #  #  ## #   #####
#  # #     #   ## ##    #  #  ##  ## #      #
#  #         #  # #   #  #    #             #
#  1       #   ###    #               #  #  #
# #           ##          #  ##  #  # # #   #
#   #     #       #   #  #   # #  ##    #   #
#      #   ##      #    ## # #  ####     ## #
#############################################
