39 38
#######################################
#                 #            #      #
#   #  #        # #                   #
#       #                             #
##                          #       # #
#      ##                   #      #  #
#    #   # #         #        # #     #
#       #   # #   #                 # #
#        #        #      #          # #
#          #                          #
#    #                     #      ##  #
#                                     #
#      #      #    #                  #
#                 ##                  #
#                         #       #   #
#         #     #                     #
#        #              #             #
#       1                             #
#     #        #                      #
#                      #        #     #
#                             2       #
#             #              #        #
#                     #     #         #
#   #       #                         #
#                  ##                 #
#                  #    #      #      #
#                                     #
#  ##      #                     #    #
#                          #          #
# #          #      #        #        #
# #                 #   # #   #       #
#     # #        #         # #   #    #
#  #      #                   ##      #
# #       #                          ##
#                             #       #
#                   # #        #  #   #
#      #            #                 #
#######################################
