16 19
################
## #      # #  #
###         # ##
#    #   #  #  #
# # # # #      #
#  ##  #    #  #
# # 1 # ## #   #
##      #    # #
# #     #    ###
####        ####
###    #     # #
# #    #      ##
#   # ## # 2 # #
#  #    #  ##  #
#      # # # # #
#  #  #   #    #
## #         ###
#  # #      # ##
################
