45 50
#############################################
#          #                  # #           #
#         #  # #  # # #    # #  #  #   #    #
#         # #         ##            #       #
#  #   # #            #      #       #      #
#   ##     #      #  #    #         #   #   #
#     ##       # #        #                 #
# #                #### #      #            #
#     #              ###  #                ##
#        #                      #        ## #
##  #      #                      # ##      #
##                              #    #      #
#           #         # ##    #  #  # #     #
#   #                   #        #          #
##    #    #    ##      #              1    #
#           #   #                   #       #
#     #        # #                  ##  #   #
#                 #                # # ##   #
#   # #  #  #                        #      #
#    #                        #      # #   ##
# #       # #      #                   #    #
#             #      #       #  #           #
#  ### #               #        #     #     #
#     #      ##            #        #       #
##                  #   #    #           #  #
#  #           #    #   #                  ##
#       #        #            ##      #     #
#     #     #        #               # ###  #
#           #  #       #      #             #
#    #                   #      # #       # #
##   # #      #                        #    #
#      #                        #  #  # #   #
#   ## # #                #                 #
#   #  ##                  # #        #     #
#       #                   #   #           #
#    2              #      ##    #    #    ##
#          #        #                   #   #
#     # #  #  #    ## #         #           #
#      #    #                              ##
#      ## #                      #      #  ##
# ##        #                      #        #
##                #  ###              #     #
#            #      # ####                # #
#                 #        # #       ##     #
#   #   #         #    #  #      #     ##   #
#      #       #      #            # #   #  #
#       #            ##         # #         #
#    #   #  #  # #    # # #  # #  #         #
#           # #                  #          #
#############################################
