45 36
#############################################
#      ##  #        # ##                    #
#           # #    #              #         #
#                          # ####           #
## #  #   # #        #  #               # # #
#  #   #  #            ##          # #      #
#   #     #  #       # # #              ##  #
#              #       #           ##      ##
##     #    #   #   #        ## # # #  # # ##
#  ##   #                        #  #       #
# #  #   # # #       ##      ##             #
#      #            # # ##    #   #  #      #
#          #                  # #       #   #
## #   #    #   #      #        #           #
# #   ##      #      #             # # # # ##
#          # #     #     #              #   #
#       #   2      ##       # ###      #    #
##                ### #     #    #        # #
# #        #    #     # ###                ##
#    #      ### #       ##      1   #       #
#   #              #     #     # #          #
## # # # #             #      #      ##   # #
#           #        #      #   #    #   # ##
#   #       # #                  #          #
#      #  #   #    ## # #            #      #
#             ##      ##       # # #   #  # #
#       #  #                        #   ##  #
## # #  # # # ##        #   #   #    #     ##
##      ##           #       #              #
#  ##              # # #       #  #     #   #
#      # #          ##            #  #   #  #
# # #               #  #        # #   #  # ##
#           #### #                          #
#         #              #    # #           #
#                    ## #        #  ##      #
#############################################
