19 24
###################
#   #         #   #
#  #   #   #      #
# #  #   # #      #
#        #    #   #
#   #        #    #
#     ##  2      ##
#     #         # #
#                 #
#                 #
#                 #
#        #        #
#        #        #
#                 #
#                 #
#                 #
# #         #     #
##      1  ##     #
#    #        #   #
#   #    #        #
#      # #   #  # #
#      #   #   #  #
#   #         #   #
###################
