44 31
############################################
#                   #    #   #           ###
#          #  #                 #       #  #
##        #     #    #                     #
#         #       #      #   #             #
#                   #              1       #
#    #               #                     #
#                           #              #
#  ###            #                   #    #
#         #   # # ##                       #
##     #        ###         #              #
#       #       #         #   #  #         #
# #      ###       #     #     #  ##   #   #
# # #          #   #     #    #            #
#                #        # # # ##         #
# #      #  #     #      #     #  #      # #
#         ## # # #        #                #
#            #    #     #   #          # # #
#   #   ##  #     #     #       ###      # #
#         #  #   #         #       #       #
#              #         ###        #     ##
#                       ## # #   #         #
#    #                   #            ###  #
#              #                           #
#                     #               #    #
#       2              #                   #
#             #   #      #       #         #
#                     #    #     #        ##
#  #       #                 #  #          #
###           #   #    #                   #
############################################
