28 15
############################
#            #             #
#           1  # #         #
#       ## #   #           #
#                 #        #
# #        #          #    #
#           ##             #
#        #        #        #
#             ##           #
#    #          #        # #
#        #                 #
#           #   # ##       #
#         # #  2           #
#             #            #
############################
